2-6080	injuring	city		month	How many ['injuring'] events happened in 11/2016 (month) in ('Texas', 'Houston') (city) ?	6	3	3	0	3	3	3
2-7179	fire_burning	city		year	How many ['fire_burning'] events happened in 2008 (year) in ('Florida', 'Miami') (city) ?	2	3	2	1	0	2	3
2-7176	fire_burning	city		year	How many ['fire_burning'] events happened in 2008 (year) in ('California', 'Los Angeles') (city) ?	10	10	10	0	0	10	10
2-6089	injuring	city		month	How many ['injuring'] events happened in 11/2014 (month) in ('California', 'San Francisco') (city) ?	2	2	2	0	0	2	2
2-7174	fire_burning	city		year	How many ['fire_burning'] events happened in 2008 (year) in ('Oregon', 'Salem') (city) ?	3	0	0	0	3	3	0
2-7175	fire_burning	city		year	How many ['fire_burning'] events happened in 2007 (year) in ('Oregon', 'Salem') (city) ?	3	0	0	0	3	3	0
2-7172	fire_burning	city		year	How many ['fire_burning'] events happened in 2008 (year) in ('Oregon', 'Portland') (city) ?	6	2	2	0	4	6	2
2-7173	fire_burning	city		year	How many ['fire_burning'] events happened in 2007 (year) in ('California', 'Los Angeles') (city) ?	30	29	29	0	1	30	29
2-7160	fire_burning	city		month	How many ['fire_burning'] events happened in 10/2007 (month) in ('California', 'Los Angeles') (city) ?	4	4	4	0	0	4	4
2-6071	injuring	state		year	How many ['injuring'] events happened in 2015 (year) in ('South Carolina',) (state) ?	3	3	1	2	2	3	3
2-6070	injuring	state		year	How many ['injuring'] events happened in 2015 (year) in ('Tennessee',) (state) ?	12	22	11	11	1	10	21
2-7168	fire_burning	city		month	How many ['fire_burning'] events happened in 05/2006 (month) in ('California', 'Los Angeles') (city) ?	2	2	2	0	0	2	2
2-6079	injuring	city		month	How many ['injuring'] events happened in 05/2016 (month) in ('Minnesota', 'Minneapolis') (city) ?	4	3	3	0	1	2	3
2-7163	fire_burning	city		month	How many ['fire_burning'] events happened in 03/2006 (month) in ('California', 'Los Angeles') (city) ?	5	6	5	1	0	5	6
2-7164	fire_burning	city		month	How many ['fire_burning'] events happened in 06/2008 (month) in ('California', 'Los Angeles') (city) ?	2	2	2	0	0	2	2
2-7162	fire_burning	city		month	How many ['fire_burning'] events happened in 02/2006 (month) in ('California', 'Los Angeles') (city) ?	4	3	3	0	1	4	3
2-6060	injuring	state		year	How many ['injuring'] events happened in 2016 (year) in ('Wisconsin',) (state) ?	13	25	8	17	5	11	23
2-7156	fire_burning	city		month	How many ['fire_burning'] events happened in 10/2008 (month) in ('Oregon', 'Portland') (city) ?	2	0	0	0	2	2	0
2-6065	injuring	state		year	How many ['injuring'] events happened in 2013 (year) in ('Arizona',) (state) ?	5	2	2	0	3	3	2
2-7154	fire_burning	city		month	How many ['fire_burning'] events happened in 07/2007 (month) in ('California', 'Los Angeles') (city) ?	3	3	3	0	0	3	3
2-6067	injuring	state		year	How many ['injuring'] events happened in 2015 (year) in ('Kentucky',) (state) ?	17	17	11	6	6	8	13
2-7155	fire_burning	city		month	How many ['fire_burning'] events happened in 06/2006 (month) in ('California', 'Los Angeles') (city) ?	2	2	2	0	0	2	1
2-6062	injuring	state		year	How many ['injuring'] events happened in 2016 (year) in ('New Jersey',) (state) ?	25	26	15	11	10	16	21
2-7152	fire_burning	city		month	How many ['fire_burning'] events happened in 10/2006 (month) in ('California', 'Los Angeles') (city) ?	4	4	4	0	0	4	4
2-6061	injuring	state		year	How many ['injuring'] events happened in 2014 (year) in ('Texas',) (state) ?	5	14	5	9	0	5	13
2-7153	fire_burning	city		month	How many ['fire_burning'] events happened in 09/2008 (month) in ('California', 'Los Angeles') (city) ?	2	2	2	0	0	2	2
2-6064	injuring	state		year	How many ['injuring'] events happened in 2016 (year) in ('Mississippi',) (state) ?	10	11	7	4	3	8	11
2-6063	injuring	state		year	How many ['injuring'] events happened in 2015 (year) in ('Maryland',) (state) ?	12	12	7	5	5	11	11
2-6069	injuring	state		year	How many ['injuring'] events happened in 2013 (year) in ('Colorado',) (state) ?	2	1	1	0	1	2	1
2-7158	fire_burning	city		month	How many ['fire_burning'] events happened in 11/2007 (month) in ('Oregon', 'Salem') (city) ?	2	0	0	0	2	2	0
2-7159	fire_burning	city		month	How many ['fire_burning'] events happened in 12/2007 (month) in ('California', 'Los Angeles') (city) ?	3	2	2	0	1	3	2
2-6055	injuring	state		year	How many ['injuring'] events happened in 2016 (year) in ('South Carolina',) (state) ?	16	23	11	12	5	10	20
2-7145	fire_burning	city		day	How many ['fire_burning'] events happened in 24/09/2006 (day) in ('California', 'Los Angeles') (city) ?	3	1	1	0	2	3	1
2-6054	injuring	state		year	How many ['injuring'] events happened in 2016 (year) in ('North Carolina',) (state) ?	33	28	20	8	13	22	24
2-6296	injuring	state		month	How many ['injuring'] events happened in 05/2015 (month) in ('Maryland',) (state) ?	2	1	1	0	1	2	1
2-7146	fire_burning	city		month	How many ['fire_burning'] events happened in 01/2006 (month) in ('California', 'Los Angeles') (city) ?	8	6	5	1	3	8	6
2-6057	injuring	state		year	How many ['injuring'] events happened in 2016 (year) in ('District of Columbia',) (state) ?	4	30	0	30	4	4	25
2-6299	injuring	state		month	How many ['injuring'] events happened in 09/2016 (month) in ('Kentucky',) (state) ?	2	2	1	1	1	2	2
2-6056	injuring	state		year	How many ['injuring'] events happened in 2015 (year) in ('Arkansas',) (state) ?	5	23	5	18	0	3	20
2-7144	fire_burning	city		day	How many ['fire_burning'] events happened in 02/07/2006 (day) in ('California', 'Los Angeles') (city) ?	3	3	3	0	0	3	2
2-6051	injuring	state		year	How many ['injuring'] events happened in 2014 (year) in ('Virginia',) (state) ?	4	7	3	4	1	4	7
2-6050	injuring	state		year	How many ['injuring'] events happened in 2015 (year) in ('Texas',) (state) ?	33	58	22	36	11	18	52
2-6053	injuring	state		year	How many ['injuring'] events happened in 2015 (year) in ('Colorado',) (state) ?	4	9	4	5	0	2	9
2-6295	injuring	state		month	How many ['injuring'] events happened in 10/2016 (month) in ('Nevada',) (state) ?	3	1	1	0	2	2	1
2-6059	injuring	state		year	How many ['injuring'] events happened in 2013 (year) in ('Illinois',) (state) ?	23	11	10	1	13	11	10
2-7149	fire_burning	city		month	How many ['fire_burning'] events happened in 08/2006 (month) in ('California', 'Los Angeles') (city) ?	6	5	5	0	1	6	5
2-6058	injuring	state		year	How many ['injuring'] events happened in 2015 (year) in ('New Jersey',) (state) ?	7	6	5	1	2	5	5
2-7148	fire_burning	city		month	How many ['fire_burning'] events happened in 07/2007 (month) in ('Nevada', 'Las Vegas') (city) ?	3	1	1	0	2	3	1
2-6280	injuring	state		month	How many ['injuring'] events happened in 08/2016 (month) in ('Virginia',) (state) ?	6	5	5	0	1	4	4
2-5197	killing	state		day	How many ['killing'] events happened in 26/07/2016 (day) in ('Texas',) (state) ?	3	3	2	1	1	2	2
2-5196	killing	state		day	How many ['killing'] events happened in 15/07/2016 (day) in ('Florida',) (state) ?	5	2	2	0	3	3	2
2-6043	injuring	state		year	How many ['injuring'] events happened in 2015 (year) in ('Virginia',) (state) ?	7	11	5	6	2	6	10
2-5199	killing		last	month	How many ['killing'] events happened in 12/2015 (month) that involve the name Johnson (last) ?	4	2	2	0	2	2	1
2-7132	fire_burning	state		month	How many ['fire_burning'] events happened in 11/2007 (month) in ('California',) (state) ?	4	4	4	0	0	4	4
2-6045	injuring	state		year	How many ['injuring'] events happened in 2013 (year) in ('Delaware',) (state) ?	3	8	0	8	3	2	8
2-6287	injuring	state		month	How many ['injuring'] events happened in 11/2016 (month) in ('Louisiana',) (state) ?	11	10	8	2	3	2	8
2-6281	injuring	state		month	How many ['injuring'] events happened in 01/2016 (month) in ('Texas',) (state) ?	4	10	4	6	0	3	10
2-6042	injuring	state		year	How many ['injuring'] events happened in 2014 (year) in ('Pennsylvania',) (state) ?	9	9	8	1	1	8	9
2-6284	injuring	state		month	How many ['injuring'] events happened in 11/2015 (month) in ('Ohio',) (state) ?	2	1	1	0	1	2	1
2-6048	injuring	state		year	How many ['injuring'] events happened in 2016 (year) in ('Louisiana',) (state) ?	36	55	30	25	6	18	49
2-7138	fire_burning	state		month	How many ['fire_burning'] events happened in 09/2007 (month) in ('California',) (state) ?	5	5	5	0	0	5	5
2-6047	injuring	state		year	How many ['injuring'] events happened in 2015 (year) in ('Nevada',) (state) ?	6	6	6	0	0	4	6
2-6289	injuring	state		month	How many ['injuring'] events happened in 12/2016 (month) in ('Arizona',) (state) ?	4	2	2	0	2	2	2
2-7139	fire_burning	state		month	How many ['fire_burning'] events happened in 05/2007 (month) in ('California',) (state) ?	2	2	2	0	0	2	2
2-7136	fire_burning	state		month	How many ['fire_burning'] events happened in 06/2007 (month) in ('Alaska',) (state) ?	2	0	0	0	2	2	0
2-6049	injuring	state		year	How many ['injuring'] events happened in 2016 (year) in ('New York',) (state) ?	44	4	4	0	40	20	3
2-5186	killing	state		day	How many ['killing'] events happened in 15/10/2016 (day) in ('Missouri',) (state) ?	3	1	1	0	2	2	1
2-7124	fire_burning	state		month	How many ['fire_burning'] events happened in 11/2005 (month) in ('California',) (state) ?	3	3	3	0	0	3	3
2-5188	killing	state		day	How many ['killing'] events happened in 28/06/2016 (day) in ('Texas',) (state) ?	6	6	6	0	0	2	3
2-6035	injuring	state		year	How many ['injuring'] events happened in 2016 (year) in ('California',) (state) ?	80	71	47	24	33	48	67
2-7121	fire_burning	state		month	How many ['fire_burning'] events happened in 05/2008 (month) in ('Florida',) (state) ?	2	3	2	1	0	2	3
2-6276	injuring	state		month	How many ['injuring'] events happened in 04/2016 (month) in ('District of Columbia',) (state) ?	2	6	0	6	2	2	4
2-5182	killing	state		day	How many ['killing'] events happened in 24/11/2016 (day) in ('New York',) (state) ?	4	1	1	0	3	2	1
2-6271	injuring	state		month	How many ['injuring'] events happened in 07/2013 (month) in ('Illinois',) (state) ?	4	1	1	0	3	2	1
2-5181	killing	state		day	How many ['killing'] events happened in 20/02/2016 (day) in ('Florida',) (state) ?	4	1	1	0	3	2	1
2-7120	fire_burning	state		month	How many ['fire_burning'] events happened in 07/2006 (month) in ('California',) (state) ?	6	6	6	0	0	6	5
2-5184	killing	state		day	How many ['killing'] events happened in 31/07/2016 (day) in ('Texas',) (state) ?	10	3	3	0	7	2	2
2-6031	injuring	state		year	How many ['injuring'] events happened in 2015 (year) in ('Mississippi',) (state) ?	9	10	6	4	3	6	9
2-5183	killing	state		day	How many ['killing'] events happened in 23/05/2014 (day) in ('California',) (state) ?	5	5	5	0	0	2	4
2-6030	injuring	state		year	How many ['injuring'] events happened in 2013 (year) in ('Michigan',) (state) ?	7	1	1	0	6	5	1
2-6272	injuring	state		month	How many ['injuring'] events happened in 04/2016 (month) in ('California',) (state) ?	7	7	3	4	4	6	7
2-6037	injuring	state		year	How many ['injuring'] events happened in 2016 (year) in ('Pennsylvania',) (state) ?	52	76	37	39	15	24	63
2-6279	injuring	state		month	How many ['injuring'] events happened in 07/2016 (month) in ('Illinois',) (state) ?	4	1	1	0	3	3	1
2-7127	fire_burning	state		month	How many ['fire_burning'] events happened in 06/2007 (month) in ('California',) (state) ?	3	3	3	0	0	3	3
2-6036	injuring	state		year	How many ['injuring'] events happened in 2014 (year) in ('Colorado',) (state) ?	3	5	3	2	0	2	4
2-6278	injuring	state		month	How many ['injuring'] events happened in 08/2016 (month) in ('Massachusetts',) (state) ?	3	2	2	0	1	2	2
2-7128	fire_burning	state		month	How many ['fire_burning'] events happened in 04/2006 (month) in ('California',) (state) ?	4	4	4	0	0	4	4
2-6038	injuring	state		year	How many ['injuring'] events happened in 2015 (year) in ('Illinois',) (state) ?	34	20	12	8	22	24	17
2-7126	fire_burning	state		month	How many ['fire_burning'] events happened in 08/2007 (month) in ('California',) (state) ?	4	4	4	0	0	4	4
2-5175	killing	city		month	How many ['killing'] events happened in 07/2016 (month) in ('Texas', 'Houston') (city) ?	9	8	8	0	1	4	7
2-6022	injuring	state		year	How many ['injuring'] events happened in 2016 (year) in ('Alabama',) (state) ?	10	12	7	5	3	10	12
2-6021	injuring	state		year	How many ['injuring'] events happened in 2014 (year) in ('Tennessee',) (state) ?	9	8	6	2	3	6	6
2-7113	fire_burning	state		month	How many ['fire_burning'] events happened in 12/2008 (month) in ('Oregon',) (state) ?	2	2	2	0	0	2	2
2-6266	injuring	state		month	How many ['injuring'] events happened in 05/2015 (month) in ('Missouri',) (state) ?	2	2	2	0	0	2	2
2-6023	injuring	state		year	How many ['injuring'] events happened in 2016 (year) in ('Tennessee',) (state) ?	39	44	27	17	12	23	43
2-6265	injuring	state		month	How many ['injuring'] events happened in 06/2016 (month) in ('Missouri',) (state) ?	2	7	2	5	0	2	7
2-6020	injuring	state		year	How many ['injuring'] events happened in 2015 (year) in ('California',) (state) ?	31	40	23	17	8	23	37
2-6029	injuring	state		year	How many ['injuring'] events happened in 2016 (year) in ('Washington',) (state) ?	11	26	11	15	0	6	26
2-6026	injuring	state		year	How many ['injuring'] events happened in 2015 (year) in ('Louisiana',) (state) ?	14	26	13	13	1	11	26
2-7116	fire_burning	state		month	How many ['fire_burning'] events happened in 09/2006 (month) in ('California',) (state) ?	6	7	6	1	0	6	6
2-5178	killing	city		month	How many ['killing'] events happened in 02/2015 (month) in ('Texas', 'Houston') (city) ?	3	1	1	0	2	2	1
2-6025	injuring	state		year	How many ['injuring'] events happened in 2016 (year) in ('Virginia',) (state) ?	22	18	14	4	8	16	17
2-6267	injuring	state		month	How many ['injuring'] events happened in 04/2016 (month) in ('Louisiana',) (state) ?	2	2	2	0	0	2	2
2-7117	fire_burning	state		month	How many ['fire_burning'] events happened in 06/2006 (month) in ('California',) (state) ?	3	3	3	0	0	3	2
2-6028	injuring	state		year	How many ['injuring'] events happened in 2015 (year) in ('Massachusetts',) (state) ?	4	3	1	2	3	2	3
2-6027	injuring	state		year	How many ['injuring'] events happened in 2016 (year) in ('Connecticut',) (state) ?	19	13	10	3	9	9	11
2-6269	injuring	state		month	How many ['injuring'] events happened in 07/2015 (month) in ('Florida',) (state) ?	3	5	3	2	0	2	5
2-7115	fire_burning	state		month	How many ['fire_burning'] events happened in 12/2005 (month) in ('California',) (state) ?	10	10	10	0	0	10	9
2-6011	injuring	state		year	How many ['injuring'] events happened in 2015 (year) in ('Ohio',) (state) ?	37	26	14	12	23	24	22
2-6253	injuring	state		month	How many ['injuring'] events happened in 01/2015 (month) in ('Wisconsin',) (state) ?	4	4	3	1	1	2	4
2-6495	injuring	city		year	How many ['injuring'] events happened in 2016 (year) in ('Missouri', 'Saint Louis') (city) ?	6	9	3	6	3	3	9
2-6252	injuring	state		month	How many ['injuring'] events happened in 11/2015 (month) in ('Wisconsin',) (state) ?	3	3	2	1	1	3	3
2-6013	injuring	state		year	How many ['injuring'] events happened in 2015 (year) in ('Alabama',) (state) ?	8	6	5	1	3	8	6
2-6255	injuring	state		month	How many ['injuring'] events happened in 08/2016 (month) in ('California',) (state) ?	10	8	6	2	4	6	7
2-5165	killing	city		month	How many ['killing'] events happened in 12/2016 (month) in ('Arkansas', 'Little Rock') (city) ?	4	1	1	0	3	2	1
2-6012	injuring	state		year	How many ['injuring'] events happened in 2014 (year) in ('California',) (state) ?	26	23	21	2	5	22	22
2-6254	injuring	state		month	How many ['injuring'] events happened in 12/2015 (month) in ('Pennsylvania',) (state) ?	7	6	6	0	1	3	6
2-7100	fire_burning	state		year	How many ['fire_burning'] events happened in 2005 (year) in ('California',) (state) ?	15	14	14	0	1	15	13
2-6491	injuring	city		year	How many ['injuring'] events happened in 2016 (year) in ('North Carolina', 'Durham') (city) ?	3	0	0	0	3	2	0
2-6490	injuring	city		year	How many ['injuring'] events happened in 2016 (year) in ('Delaware', 'Wilmington') (city) ?	3	0	0	0	3	2	0
2-6250	injuring	state		month	How many ['injuring'] events happened in 10/2015 (month) in ('South Carolina',) (state) ?	2	1	1	0	1	2	1
2-6492	injuring	city		year	How many ['injuring'] events happened in 2016 (year) in ('North Carolina', 'Rocky Mount') (city) ?	2	0	0	0	2	2	0
2-6019	injuring	state		year	How many ['injuring'] events happened in 2014 (year) in ('Wisconsin',) (state) ?	2	4	2	2	0	2	4
2-6018	injuring	state		year	How many ['injuring'] events happened in 2016 (year) in ('Texas',) (state) ?	121	162	98	64	23	54	138
2-6015	injuring	state		year	How many ['injuring'] events happened in 2016 (year) in ('Vermont',) (state) ?	4	4	3	1	1	2	3
2-6257	injuring	state		month	How many ['injuring'] events happened in 11/2015 (month) in ('California',) (state) ?	6	5	2	3	4	4	5
2-6499	injuring	city		year	How many ['injuring'] events happened in 2016 (year) in ('Texas', 'Fort Worth') (city) ?	5	6	3	3	2	3	6
2-6014	injuring	state		year	How many ['injuring'] events happened in 2016 (year) in ('Ohio',) (state) ?	30	56	23	33	7	20	52
2-6498	injuring	city		year	How many ['injuring'] events happened in 2016 (year) in ('Connecticut', 'Bridgeport') (city) ?	10	3	3	0	7	4	2
2-6017	injuring	state		year	How many ['injuring'] events happened in 2013 (year) in ('Maryland',) (state) ?	10	9	8	1	2	4	9
2-6016	injuring	state		year	How many ['injuring'] events happened in 2014 (year) in ('Washington',) (state) ?	4	7	1	6	3	2	7
2-7104	fire_burning	state		year	How many ['fire_burning'] events happened in 2006 (year) in ('California',) (state) ?	49	49	48	1	1	49	46
2-6000	injuring	state		year	How many ['injuring'] events happened in 2013 (year) in ('Virginia',) (state) ?	2	2	2	0	0	2	2
2-6484	injuring	city		year	How many ['injuring'] events happened in 2016 (year) in ('California', 'Sacramento') (city) ?	13	4	4	0	9	6	4
2-5152	killing	city		month	How many ['killing'] events happened in 04/2016 (month) in ('Wisconsin', 'Milwaukee') (city) ?	2	2	2	0	0	2	2
2-6241	injuring	state		month	How many ['injuring'] events happened in 08/2016 (month) in ('North Carolina',) (state) ?	4	3	1	2	3	2	3
2-5155	killing	city		month	How many ['killing'] events happened in 12/2016 (month) in ('Ohio', 'Toledo') (city) ?	5	4	4	0	1	2	3
2-5397	killing		first	year	How many ['killing'] events happened in 2015 (year) that involve the name Christopher (first) ?	5	2	1	1	4	4	2
2-6002	injuring	state		year	How many ['injuring'] events happened in 2016 (year) in ('Minnesota',) (state) ?	14	15	13	2	1	7	14
2-6486	injuring	city		year	How many ['injuring'] events happened in 2015 (year) in ('Florida', 'Miami') (city) ?	4	8	4	4	0	3	8
2-5154	killing	city		month	How many ['killing'] events happened in 11/2016 (month) in ('Indiana', 'Indianapolis') (city) ?	4	3	2	1	2	2	3
2-6001	injuring	state		year	How many ['injuring'] events happened in 2015 (year) in ('North Carolina',) (state) ?	17	19	13	6	4	12	17
2-6480	injuring	city		year	How many ['injuring'] events happened in 2015 (year) in ('Oklahoma', 'Tulsa') (city) ?	2	2	1	1	1	2	2
2-5151	killing	city		month	How many ['killing'] events happened in 06/2014 (month) in ('Florida', 'Miami') (city) ?	3	3	3	0	0	2	3
2-5392	killing		first	year	How many ['killing'] events happened in 2016 (year) that involve the name Travon (first) ?	11	4	4	0	7	2	2
2-6481	injuring	city		year	How many ['injuring'] events happened in 2016 (year) in ('Nevada', 'Las Vegas') (city) ?	19	14	9	5	10	8	13
2-6008	injuring	state		year	How many ['injuring'] events happened in 2015 (year) in ('Georgia',) (state) ?	20	19	12	7	8	14	17
2-5157	killing	city		month	How many ['killing'] events happened in 11/2016 (month) in ('Arkansas', 'Little Rock') (city) ?	7	2	2	0	5	2	2
2-6004	injuring	state		year	How many ['injuring'] events happened in 2015 (year) in ('Oklahoma',) (state) ?	4	6	3	3	1	4	6
2-5156	killing	city		month	How many ['killing'] events happened in 09/2016 (month) in ('Texas', 'Fort Worth') (city) ?	5	1	1	0	4	2	1
2-6006	injuring	state		year	How many ['injuring'] events happened in 2014 (year) in ('New Jersey',) (state) ?	3	2	2	0	1	3	2
2-6005	injuring	state		year	How many ['injuring'] events happened in 2014 (year) in ('Florida',) (state) ?	9	10	6	4	3	7	10
2-6247	injuring	state		month	How many ['injuring'] events happened in 06/2015 (month) in ('Pennsylvania',) (state) ?	6	5	5	0	1	5	5
2-6489	injuring	city		year	How many ['injuring'] events happened in 2016 (year) in ('North Carolina', 'Wilmington') (city) ?	3	3	3	0	0	2	2
2-5384	killing		first	year	How many ['killing'] events happened in 2015 (year) that involve the name Kyle (first) ?	4	1	1	0	3	2	1
2-6231	injuring	state		month	How many ['injuring'] events happened in 11/2015 (month) in ('Michigan',) (state) ?	5	1	1	0	4	3	1
2-6473	injuring	city		year	How many ['injuring'] events happened in 2013 (year) in ('California', 'Fresno') (city) ?	2	0	0	0	2	2	0
2-6472	injuring	city		year	How many ['injuring'] events happened in 2014 (year) in ('Louisiana', 'New Orleans') (city) ?	6	2	1	1	5	2	2
2-6233	injuring	state		month	How many ['injuring'] events happened in 04/2015 (month) in ('North Carolina',) (state) ?	4	3	3	0	1	2	2
2-6475	injuring	city		year	How many ['injuring'] events happened in 2016 (year) in ('Missouri', 'Kansas City') (city) ?	6	7	3	4	3	4	7
2-5385	killing		first	year	How many ['killing'] events happened in 2016 (year) that involve the name Vincent (first) ?	4	0	0	0	4	2	0
2-6232	injuring	state		month	How many ['injuring'] events happened in 01/2013 (month) in ('California',) (state) ?	2	0	0	0	2	2	0
2-6474	injuring	city		year	How many ['injuring'] events happened in 2014 (year) in ('Nevada', 'Las Vegas') (city) ?	3	2	1	1	2	2	2
2-6471	injuring	city		year	How many ['injuring'] events happened in 2016 (year) in ('Virginia', 'Richmond') (city) ?	3	3	1	2	2	2	2
2-5381	killing		first	year	How many ['killing'] events happened in 2015 (year) that involve the name Trevor (first) ?	3	1	1	0	2	2	1
2-6470	injuring	city		year	How many ['injuring'] events happened in 2016 (year) in ('Illinois', 'Chicago (Englewood)') (city) ?	8	24	4	20	4	6	22
2-6239	injuring	state		month	How many ['injuring'] events happened in 09/2014 (month) in ('California',) (state) ?	3	2	1	1	2	3	2
2-6238	injuring	state		month	How many ['injuring'] events happened in 04/2016 (month) in ('Florida',) (state) ?	8	7	4	3	4	3	6
2-6235	injuring	state		month	How many ['injuring'] events happened in 02/2015 (month) in ('Texas',) (state) ?	3	7	2	5	1	2	7
2-6477	injuring	city		year	How many ['injuring'] events happened in 2015 (year) in ('Indiana', 'Indianapolis') (city) ?	9	3	3	0	6	5	3
2-5387	killing		first	year	How many ['killing'] events happened in 2014 (year) that involve the name Christopher (first) ?	5	2	2	0	3	2	1
2-6476	injuring	city		year	How many ['injuring'] events happened in 2016 (year) in ('New York', 'Brooklyn') (city) ?	14	8	4	4	10	6	5
2-6479	injuring	city		year	How many ['injuring'] events happened in 2015 (year) in ('North Carolina', 'Raleigh') (city) ?	4	3	3	0	1	2	2
2-6478	injuring	city		year	How many ['injuring'] events happened in 2016 (year) in ('Tennessee', 'Chattanooga') (city) ?	3	1	1	0	2	2	1
2-5131	killing	state		month	How many ['killing'] events happened in 12/2016 (month) in ('South Carolina',) (state) ?	3	1	1	0	2	2	1
2-5133	killing	state		month	How many ['killing'] events happened in 05/2016 (month) in ('New York',) (state) ?	6	0	0	0	6	2	0
2-6222	injuring	state		month	How many ['injuring'] events happened in 12/2015 (month) in ('California',) (state) ?	7	7	6	1	1	5	6
2-6464	injuring	city		year	How many ['injuring'] events happened in 2015 (year) in ('Texas', 'Dallas') (city) ?	5	2	2	0	3	3	2
2-6221	injuring	state		month	How many ['injuring'] events happened in 08/2015 (month) in ('Pennsylvania',) (state) ?	5	4	2	2	3	3	3
2-1	fire_burning	state		year	How many ['fire_burning'] events happened in 2015 (year) in ('Connecticut',) (state) ?	0	0	0	0	0	0	0
2-5371	killing		first	year	How many ['killing'] events happened in 2013 (year) that involve the name Brandon (first) ?	3	1	1	0	2	2	1
2-6460	injuring	city		year	How many ['injuring'] events happened in 2016 (year) in ('Arizona', 'Phoenix') (city) ?	4	6	2	4	2	3	6
2-2	fire_burning	state		year	How many ['fire_burning'] events happened in 2014 (year) in ('Ohio',) (state) ?	0	0	0	0	0	0	0
2-5370	killing		first	year	How many ['killing'] events happened in 2016 (year) that involve the name Diana (first) ?	4	2	2	0	2	2	2
2-3	killing	state		year	How many ['killing'] events happened in 2008 (year) in ('Washington',) (state) ?	0	0	0	0	0	0	0
2-5139	killing	city		month	How many ['killing'] events happened in 07/2015 (month) in ('Maryland', 'Baltimore') (city) ?	2	0	0	0	2	2	0
2-4	fire_burning	state		year	How many ['fire_burning'] events happened in 2015 (year) in ('Michigan',) (state) ?	0	0	0	0	0	0	0
2-5	job_firing	state		year	How many ['job_firing'] events happened in 2013 (year) in ('Pennsylvania',) (state) ?	0	0	0	0	0	0	0
2-6	fire_burning	state		year	How many ['fire_burning'] events happened in 2014 (year) in ('Louisiana',) (state) ?	0	1	0	1	0	0	1
2-6224	injuring	state		month	How many ['injuring'] events happened in 07/2015 (month) in ('Kansas',) (state) ?	2	2	0	2	2	2	2
2-6466	injuring	city		year	How many ['injuring'] events happened in 2015 (year) in ('Missouri', 'Saint Louis') (city) ?	4	2	1	1	3	3	2
2-7	injuring	city		year	How many ['injuring'] events happened in 2016 (year) in ('California', 'Palo Alto') (city) ?	0	0	0	0	0	0	0
2-8	injuring	city		year	How many ['injuring'] events happened in 2015 (year) in ('North Carolina', 'Henderson') (city) ?	0	0	0	0	0	0	0
2-5137	killing	state		month	How many ['killing'] events happened in 07/2016 (month) in ('Arizona',) (state) ?	2	2	2	0	0	2	2
2-5379	killing		first	year	How many ['killing'] events happened in 2016 (year) that involve the name Justin (first) ?	6	2	2	0	4	2	1
2-6468	injuring	city		year	How many ['injuring'] events happened in 2016 (year) in ('California', 'San Francisco') (city) ?	7	9	6	3	1	3	8
2-9	injuring	city		year	How many ['injuring'] events happened in 2014 (year) in ('Kentucky', 'Louisville') (city) ?	0	0	0	0	0	0	0
2-5136	killing	state		month	How many ['killing'] events happened in 10/2016 (month) in ('Illinois',) (state) ?	10	5	4	1	6	7	4
2-5378	killing		first	year	How many ['killing'] events happened in 2015 (year) that involve the name Michael (first) ?	7	7	3	4	4	4	6
2-6225	injuring	state		month	How many ['injuring'] events happened in 06/2016 (month) in ('Massachusetts',) (state) ?	7	9	6	3	1	2	8
2-6467	injuring	city		year	How many ['injuring'] events happened in 2016 (year) in ('Virginia', 'Portsmouth') (city) ?	4	4	4	0	0	3	4
2-6209	injuring	state		month	How many ['injuring'] events happened in 02/2016 (month) in ('Virginia',) (state) ?	5	4	4	0	1	3	4
2-6451	injuring	city		year	How many ['injuring'] events happened in 2015 (year) in ('Maryland', 'Baltimore') (city) ?	11	8	6	2	5	10	8
2-6695	injuring		last	year	How many ['injuring'] events happened in 2015 (year) that involve the name Clayton (last) ?	5	3	3	0	2	2	3
2-5363	killing		first	year	How many ['killing'] events happened in 2015 (year) that involve the name David (first) ?	4	1	0	1	4	2	1
2-6452	injuring	city		year	How many ['injuring'] events happened in 2015 (year) in ('Florida', 'Lakeland') (city) ?	2	0	0	0	2	2	0
2-6690	injuring		last	year	How many ['injuring'] events happened in 2016 (year) that involve the name Miller (last) ?	7	6	1	5	6	3	5
2-5128	killing	state		month	How many ['killing'] events happened in 10/2016 (month) in ('Missouri',) (state) ?	6	3	3	0	3	4	3
2-6459	injuring	city		year	How many ['injuring'] events happened in 2016 (year) in ('Louisiana', 'New Orleans') (city) ?	15	15	8	7	7	6	13
2-5127	killing	state		month	How many ['killing'] events happened in 12/2016 (month) in ('Arkansas',) (state) ?	6	6	4	2	2	3	4
2-6216	injuring	state		month	How many ['injuring'] events happened in 03/2015 (month) in ('California',) (state) ?	4	4	2	2	2	3	4
2-6219	injuring	state		month	How many ['injuring'] events happened in 11/2015 (month) in ('Pennsylvania',) (state) ?	3	2	2	0	1	2	1
2-5129	killing	state		month	How many ['killing'] events happened in 08/2015 (month) in ('Missouri',) (state) ?	4	3	0	3	4	2	3
2-6218	injuring	state		month	How many ['injuring'] events happened in 11/2013 (month) in ('California',) (state) ?	4	2	2	0	2	2	1
2-6213	injuring	state		month	How many ['injuring'] events happened in 10/2016 (month) in ('Florida',) (state) ?	5	6	5	1	0	4	6
2-6455	injuring	city		year	How many ['injuring'] events happened in 2015 (year) in ('Georgia', 'Atlanta') (city) ?	5	8	4	4	1	2	8
2-6212	injuring	state		month	How many ['injuring'] events happened in 08/2013 (month) in ('New Jersey',) (state) ?	2	3	2	1	0	2	3
2-6454	injuring	city		year	How many ['injuring'] events happened in 2014 (year) in ('California', 'San Francisco') (city) ?	4	4	4	0	0	3	4
2-6457	injuring	city		year	How many ['injuring'] events happened in 2016 (year) in ('North Carolina', 'Charlotte') (city) ?	4	0	0	0	4	3	0
2-6699	injuring		last	year	How many ['injuring'] events happened in 2016 (year) that involve the name Stewart (last) ?	6	1	0	1	6	2	1
2-5125	killing	state		month	How many ['killing'] events happened in 11/2016 (month) in ('Michigan',) (state) ?	4	3	1	2	3	3	3
2-6214	injuring	state		month	How many ['injuring'] events happened in 05/2016 (month) in ('Georgia',) (state) ?	3	1	1	0	2	2	1
2-15	injuring	city		year	How many ['injuring'] events happened in 2008 (year) in ('West Virginia', 'White Sulphur Springs') (city) ?	0	0	0	0	0	0	0
2-14	injuring	city		year	How many ['injuring'] events happened in 2014 (year) in ('North Carolina', 'Wilmington') (city) ?	0	0	0	0	0	0	0
2-13	fire_burning	city		year	How many ['fire_burning'] events happened in 2016 (year) in ('North Carolina', 'Rocky Mount') (city) ?	0	0	0	0	0	0	0
2-12	injuring	city		year	How many ['injuring'] events happened in 2016 (year) in ('Mississippi', 'Forest') (city) ?	0	0	0	0	0	0	0
2-11	job_firing	city		year	How many ['job_firing'] events happened in 2015 (year) in ('California', 'Sacramento') (city) ?	0	1	0	1	0	0	1
2-10	fire_burning	city		year	How many ['fire_burning'] events happened in 2016 (year) in ('Texas', 'Lubbock') (city) ?	0	0	0	0	0	0	0
2-6440	injuring	city		year	How many ['injuring'] events happened in 2016 (year) in ('California', 'Fresno') (city) ?	8	4	4	0	4	6	4
2-5350	killing		first	year	How many ['killing'] events happened in 2015 (year) that involve the name Corey (first) ?	7	1	1	0	6	2	1
2-5353	killing		first	year	How many ['killing'] events happened in 2016 (year) that involve the name Jesse (first) ?	6	0	0	0	6	2	0
2-5595	killing		last	year	How many ['killing'] events happened in 2013 (year) that involve the name Williams (last) ?	4	1	1	0	3	2	1
2-6200	injuring	state		month	How many ['injuring'] events happened in 07/2015 (month) in ('Pennsylvania',) (state) ?	6	2	1	1	5	2	2
2-5590	killing		last	year	How many ['killing'] events happened in 2016 (year) that involve the name Andrews (last) ?	3	3	3	0	0	2	2
2-5359	killing		first	year	How many ['killing'] events happened in 2014 (year) that involve the name Eugene (first) ?	3	1	1	0	2	2	1
2-6206	injuring	state		month	How many ['injuring'] events happened in 11/2015 (month) in ('Alabama',) (state) ?	2	0	0	0	2	2	0
2-6449	injuring	city		year	How many ['injuring'] events happened in 2016 (year) in ('Texas', 'Houston') (city) ?	31	32	21	11	10	12	31
2-5113	killing	state		month	How many ['killing'] events happened in 08/2016 (month) in ('Georgia',) (state) ?	3	4	2	2	1	2	3
2-5355	killing		first	year	How many ['killing'] events happened in 2016 (year) that involve the name Daniel (first) ?	3	3	1	2	2	3	3
2-6444	injuring	city		year	How many ['injuring'] events happened in 2015 (year) in ('Texas', 'Houston') (city) ?	6	12	5	7	1	5	12
2-6686	injuring		last	year	How many ['injuring'] events happened in 2016 (year) that involve the name Davis (last) ?	9	12	2	10	7	4	9
2-6201	injuring	state		month	How many ['injuring'] events happened in 07/2015 (month) in ('Michigan',) (state) ?	3	0	0	0	3	3	0
2-5357	killing		first	year	How many ['killing'] events happened in 2016 (year) that involve the name Justice (first) ?	3	1	1	0	2	2	1
2-6204	injuring	state		month	How many ['injuring'] events happened in 12/2016 (month) in ('New York',) (state) ?	7	0	0	0	7	3	0
2-6446	injuring	city		year	How many ['injuring'] events happened in 2016 (year) in ('Louisiana', 'Baton Rouge') (city) ?	8	8	5	3	3	5	6
2-6445	injuring	city		year	How many ['injuring'] events happened in 2015 (year) in ('Florida', 'Miami Gardens') (city) ?	3	3	3	0	0	2	3
2-6429	injuring	city		year	How many ['injuring'] events happened in 2015 (year) in ('Kentucky', 'Lexington') (city) ?	4	0	0	0	4	2	0
2-26	injuring	city		day	How many ['injuring'] events happened in 18/10/2015 (day) in ('Oregon', 'Portland') (city) ?	0	0	0	0	0	0	0
2-25	fire_burning	city		day	How many ['fire_burning'] events happened in 19/09/2015 (day) in ('Alabama', 'Montgomery') (city) ?	0	0	0	0	0	0	0
2-24	fire_burning	city		day	How many ['fire_burning'] events happened in 11/05/2014 (day) in ('California', 'Los Angeles') (city) ?	0	0	0	0	0	0	0
2-23	injuring	city		day	How many ['injuring'] events happened in 12/10/2014 (day) in ('Indiana', 'Indianapolis') (city) ?	0	0	0	0	0	0	0
2-22	fire_burning	city		day	How many ['fire_burning'] events happened in 23/07/2016 (day) in ('Ohio', 'Akron') (city) ?	0	0	0	0	0	0	0
2-21	killing	city		day	How many ['killing'] events happened in 05/08/2016 (day) in ('Florida', 'Winter Haven') (city) ?	0	0	0	0	0	0	0
2-20	injuring	city		day	How many ['injuring'] events happened in 24/11/2016 (day) in ('Nevada', 'Las Vegas') (city) ?	0	0	0	0	0	0	0
2-6670	injuring		last	year	How many ['injuring'] events happened in 2015 (year) that involve the name Jones (last) ?	15	4	4	0	11	5	3
2-6431	injuring	city		year	How many ['injuring'] events happened in 2016 (year) in ('Mississippi', 'Jackson') (city) ?	3	7	2	5	1	2	6
2-5341	killing		first	year	How many ['killing'] events happened in 2015 (year) that involve the name Anthony (first) ?	5	0	0	0	5	2	0
2-6430	injuring	city		year	How many ['injuring'] events happened in 2016 (year) in ('Maryland', 'Baltimore') (city) ?	16	6	4	2	12	10	6
2-19	injuring	city		day	How many ['injuring'] events happened in 06/12/2014 (day) in ('California', 'Los Angeles (county)') (city) ?	0	0	0	0	0	0	0
2-18	injuring	city		day	How many ['injuring'] events happened in 20/06/2007 (day) in ('Texas', 'Crosby') (city) ?	0	0	0	0	0	0	0
2-17	fire_burning	city		day	How many ['fire_burning'] events happened in 19/12/2016 (day) in ('Louisiana', 'Monroe') (city) ?	0	0	0	0	0	0	0
2-16	killing	city		day	How many ['killing'] events happened in 18/09/2016 (day) in ('Florida', 'Fort Myers') (city) ?	0	0	0	0	0	0	0
2-6437	injuring	city		year	How many ['injuring'] events happened in 2016 (year) in ('Pennsylvania', 'Pittsburgh') (city) ?	11	19	10	9	1	4	13
2-6679	injuring		last	year	How many ['injuring'] events happened in 2015 (year) that involve the name Walker (last) ?	4	3	3	0	1	2	2
2-6436	injuring	city		year	How many ['injuring'] events happened in 2015 (year) in ('Ohio', 'Cincinnati') (city) ?	4	4	1	3	3	3	3
2-5108	killing	state		month	How many ['killing'] events happened in 04/2016 (month) in ('Missouri',) (state) ?	2	1	1	0	1	2	1
2-6439	injuring	city		year	How many ['injuring'] events happened in 2015 (year) in ('North Carolina', 'Charlotte') (city) ?	4	0	0	0	4	3	0
2-6433	injuring	city		year	How many ['injuring'] events happened in 2015 (year) in ('Ohio', 'Toledo') (city) ?	7	2	2	0	5	3	1
2-5101	killing	state		month	How many ['killing'] events happened in 10/2016 (month) in ('Washington',) (state) ?	6	3	3	0	3	2	3
2-6432	injuring	city		year	How many ['injuring'] events happened in 2016 (year) in ('Texas', 'Waco') (city) ?	2	2	2	0	0	2	2
2-5104	killing	state		month	How many ['killing'] events happened in 12/2016 (month) in ('Virginia',) (state) ?	2	1	1	0	1	2	1
2-5346	killing		first	year	How many ['killing'] events happened in 2016 (year) that involve the name Jordan (first) ?	11	0	0	0	11	2	0
2-5329	killing		first	year	How many ['killing'] events happened in 2015 (year) that involve the name Cameron (first) ?	3	0	0	0	3	2	0
2-37	injuring	city		day	How many ['injuring'] events happened in 07/12/2013 (day) in ('Wisconsin', 'Milwaukee') (city) ?	0	0	0	0	0	0	0
2-36	injuring	city		day	How many ['injuring'] events happened in 06/09/2016 (day) in ('Missouri', 'Saint Louis') (city) ?	0	0	0	0	0	0	0
2-35	fire_burning	city		day	How many ['fire_burning'] events happened in 10/03/2016 (day) in ('Illinois', 'Chicago (Englewood)') (city) ?	0	0	0	0	0	0	0
2-34	injuring	city		day	How many ['injuring'] events happened in 25/09/2016 (day) in ('Texas', 'Dallas') (city) ?	0	0	0	0	0	0	0
2-33	injuring	city		day	How many ['injuring'] events happened in 08/01/2015 (day) in ('Texas', 'Dallas') (city) ?	0	0	0	0	0	0	0
2-32	injuring	city		day	How many ['injuring'] events happened in 02/07/2015 (day) in ('Texas', 'Austin') (city) ?	0	0	0	0	0	0	0
2-31	injuring	city		day	How many ['injuring'] events happened in 25/02/2016 (day) in ('California', 'Los Angeles') (city) ?	0	0	0	0	0	0	0
2-30	injuring	city		day	How many ['injuring'] events happened in 29/06/2014 (day) in ('North Carolina', 'Goldsboro') (city) ?	0	0	0	0	0	0	0
2-5570	killing		last	year	How many ['killing'] events happened in 2016 (year) that involve the name Davis (last) ?	12	10	7	3	5	5	7
2-6661	injuring		last	year	How many ['injuring'] events happened in 2016 (year) that involve the name Jackson (last) ?	12	13	5	8	7	4	12
2-29	injuring	city		day	How many ['injuring'] events happened in 10/05/2015 (day) in ('Massachusetts', 'Springfield') (city) ?	0	0	0	0	0	0	0
2-28	injuring	city		day	How many ['injuring'] events happened in 16/07/2016 (day) in ('Florida', 'Plant City') (city) ?	0	0	0	0	0	0	0
2-27	killing	city		day	How many ['killing'] events happened in 01/07/2016 (day) in ('California', 'Los Angeles') (city) ?	0	0	0	0	0	0	0
2-5579	killing		last	year	How many ['killing'] events happened in 2016 (year) that involve the name Rollins (last) ?	4	4	4	0	0	2	3
2-6669	injuring		last	year	How many ['injuring'] events happened in 2015 (year) that involve the name Brown (last) ?	5	2	1	1	4	2	2
2-5334	killing		first	year	How many ['killing'] events happened in 2016 (year) that involve the name Eric (first) ?	10	4	3	1	7	3	4
2-5576	killing		last	year	How many ['killing'] events happened in 2016 (year) that involve the name Price (last) ?	4	2	1	1	3	2	2
2-40	killing	city		day	How many ['killing'] events happened in 08/09/2015 (day) in ('California', 'Antioch') (city) ?	0	0	0	0	0	0	0
2-48	fire_burning	state		month	How many ['fire_burning'] events happened in 12/2014 (month) in ('New York',) (state) ?	0	0	0	0	0	0	0
2-47	injuring	state		month	How many ['injuring'] events happened in 05/2016 (month) in ('Colorado',) (state) ?	0	0	0	0	0	0	0
2-46	injuring	state		month	How many ['injuring'] events happened in 11/2007 (month) in ('Washington',) (state) ?	0	0	0	0	0	0	0
2-45	fire_burning	state		month	How many ['fire_burning'] events happened in 10/2016 (month) in ('Virginia',) (state) ?	0	0	0	0	0	0	0
2-44	fire_burning	state		month	How many ['fire_burning'] events happened in 11/2016 (month) in ('California',) (state) ?	0	0	0	0	0	0	0
2-43	injuring	city		day	How many ['injuring'] events happened in 27/08/2016 (day) in ('Texas', 'Houston') (city) ?	0	0	0	0	0	0	0
2-42	injuring	city		day	How many ['injuring'] events happened in 23/11/2016 (day) in ('Connecticut', 'Bridgeport') (city) ?	0	0	0	0	0	0	0
2-41	injuring	city		day	How many ['injuring'] events happened in 10/06/2016 (day) in ('Indiana', 'Georgetown') (city) ?	0	0	0	0	0	0	0
2-6891	injuring		first	year	How many ['injuring'] events happened in 2015 (year) that involve the name Nicholas (first) ?	4	2	2	0	2	2	2
2-6893	injuring		first	year	How many ['injuring'] events happened in 2014 (year) that involve the name Kenneth (first) ?	6	2	2	0	4	3	2
2-5561	killing		last	year	How many ['killing'] events happened in 2015 (year) that involve the name Robinson (last) ?	5	1	0	1	5	2	1
2-39	killing	city		day	How many ['killing'] events happened in 21/07/2007 (day) in ('Kansas', 'Wichita') (city) ?	0	0	0	0	0	0	0
2-38	injuring	city		day	How many ['injuring'] events happened in 26/07/2014 (day) in ('Missouri', 'Hazelwood') (city) ?	0	0	0	0	0	0	0
2-6899	injuring		first	year	How many ['injuring'] events happened in 2016 (year) that involve the name Travis (first) ?	4	0	0	0	4	2	0
2-5325	killing		first	year	How many ['killing'] events happened in 2016 (year) that involve the name Darian (first) ?	3	2	2	0	1	2	2
2-6414	injuring	state		month	How many ['injuring'] events happened in 06/2015 (month) in ('New York',) (state) ?	8	0	0	0	8	5	0
2-5328	killing		first	year	How many ['killing'] events happened in 2015 (year) that involve the name Jonathan (first) ?	4	2	2	0	2	2	1
2-6417	injuring	state		month	How many ['injuring'] events happened in 07/2015 (month) in ('Kentucky',) (state) ?	7	7	6	1	1	3	5
2-6658	injuring		first	day	How many ['injuring'] events happened in 21/08/2015 (day) that involve the name Dale (first) ?	4	2	2	0	2	2	1
2-6411	injuring	state		month	How many ['injuring'] events happened in 11/2016 (month) in ('Connecticut',) (state) ?	3	4	2	2	1	2	4
2-5321	killing		first	year	How many ['killing'] events happened in 2016 (year) that involve the name David (first) ?	4	3	2	1	2	2	3
2-6655	injuring		last	day	How many ['injuring'] events happened in 24/07/2015 (day) that involve the name Franklin (last) ?	7	1	1	0	6	2	1
2-6896	injuring		first	year	How many ['injuring'] events happened in 2016 (year) that involve the name Ava (first) ?	5	1	1	0	4	2	1
2-51	fire_burning	state		month	How many ['fire_burning'] events happened in 07/2016 (month) in ('Illinois',) (state) ?	0	0	0	0	0	0	0
2-50	injuring	state		month	How many ['injuring'] events happened in 06/2014 (month) in ('Virginia',) (state) ?	0	0	0	0	0	0	0
2-6639	injuring		last	month	How many ['injuring'] events happened in 12/2016 (month) that involve the name Thomas (last) ?	2	4	2	2	0	2	4
2-59	fire_burning	city		month	How many ['fire_burning'] events happened in 06/2016 (month) in ('North Carolina', 'Raleigh') (city) ?	0	0	0	0	0	0	0
2-58	fire_burning	city		month	How many ['fire_burning'] events happened in 03/2016 (month) in ('Florida', 'Palatka') (city) ?	0	0	0	0	0	0	0
2-57	injuring	city		month	How many ['injuring'] events happened in 04/2016 (month) in ('Virginia', 'Annandale') (city) ?	0	0	0	0	0	0	0
2-56	fire_burning	state		month	How many ['fire_burning'] events happened in 01/2016 (month) in ('Pennsylvania',) (state) ?	0	0	0	0	0	0	0
2-55	injuring	state		month	How many ['injuring'] events happened in 01/2016 (month) in ('Connecticut',) (state) ?	0	0	0	0	0	0	0
2-54	killing	state		month	How many ['killing'] events happened in 03/2015 (month) in ('Maryland',) (state) ?	0	0	0	0	0	0	0
2-53	injuring	state		month	How many ['injuring'] events happened in 06/2015 (month) in ('Alabama',) (state) ?	0	0	0	0	0	0	0
2-52	fire_burning	state		month	How many ['fire_burning'] events happened in 08/2016 (month) in ('Utah',) (state) ?	0	0	0	0	0	0	0
2-5551	killing		last	year	How many ['killing'] events happened in 2016 (year) that involve the name Morris (last) ?	4	3	3	0	1	2	1
2-6881	injuring		first	year	How many ['injuring'] events happened in 2016 (year) that involve the name Richard (first) ?	4	3	0	3	4	2	3
2-49	fire_burning	state		month	How many ['fire_burning'] events happened in 01/2015 (month) in ('California',) (state) ?	0	1	0	1	0	0	1
2-6646	injuring		last	month	How many ['injuring'] events happened in 10/2016 (month) that involve the name Davis (last) ?	6	1	1	0	5	3	1
2-6887	injuring		first	year	How many ['injuring'] events happened in 2016 (year) that involve the name Roy (first) ?	3	2	2	0	1	2	1
2-5317	killing		first	year	How many ['killing'] events happened in 2016 (year) that involve the name Nathaniel (first) ?	4	0	0	0	4	2	0
2-5559	killing		last	year	How many ['killing'] events happened in 2016 (year) that involve the name Miller (last) ?	6	6	1	5	5	2	5
2-6406	injuring	state		month	How many ['injuring'] events happened in 08/2016 (month) in ('South Carolina',) (state) ?	3	2	1	1	2	3	2
2-6889	injuring		first	year	How many ['injuring'] events happened in 2016 (year) that involve the name Tony (first) ?	4	3	2	1	2	2	3
2-5553	killing		last	year	How many ['killing'] events happened in 2016 (year) that involve the name Adams (last) ?	7	1	1	0	6	3	1
2-6400	injuring	state		month	How many ['injuring'] events happened in 09/2016 (month) in ('Pennsylvania',) (state) ?	5	9	4	5	1	3	7
2-5794	killing		last	year	How many ['killing'] events happened in 2016 (year) that involve the name Johnson (last) ?	19	5	5	0	14	8	4
2-6886	injuring		first	year	How many ['injuring'] events happened in 2015 (year) that involve the name Pamela (first) ?	4	1	1	0	3	3	1
2-5312	killing		first	year	How many ['killing'] events happened in 2014 (year) that involve the name Eric (first) ?	2	1	1	0	1	2	1
2-6401	injuring	state		month	How many ['injuring'] events happened in 08/2015 (month) in ('Ohio',) (state) ?	6	1	1	0	5	3	1
2-62	killing	city		month	How many ['killing'] events happened in 10/2016 (month) in ('Nebraska', 'Omaha') (city) ?	0	0	0	0	0	0	0
2-61	injuring	city		month	How many ['injuring'] events happened in 08/2015 (month) in ('Illinois', 'Champaign') (city) ?	0	0	0	0	0	0	0
2-60	injuring	city		month	How many ['injuring'] events happened in 12/2015 (month) in ('Maryland', 'Baltimore') (city) ?	0	0	0	0	0	0	0
2-69	fire_burning	city		month	How many ['fire_burning'] events happened in 08/2016 (month) in ('Texas', 'Dallas') (city) ?	0	0	0	0	0	0	0
2-68	killing	city		month	How many ['killing'] events happened in 02/2013 (month) in ('California', 'Oakland') (city) ?	0	0	0	0	0	0	0
2-67	injuring	city		month	How many ['injuring'] events happened in 07/2016 (month) in ('Oregon', 'Salem') (city) ?	0	0	0	0	0	0	0
2-66	injuring	city		month	How many ['injuring'] events happened in 10/2015 (month) in ('Oklahoma', 'Tulsa') (city) ?	0	0	0	0	0	0	0
2-65	injuring	city		month	How many ['injuring'] events happened in 02/2006 (month) in ('Pennsylvania', 'Saltsburg') (city) ?	0	0	0	0	0	0	0
2-64	killing	city		month	How many ['killing'] events happened in 04/2016 (month) in ('Texas', 'Cypress') (city) ?	0	0	0	0	0	0	0
2-63	injuring	city		month	How many ['injuring'] events happened in 10/2016 (month) in ('Ohio', 'Cincinnati') (city) ?	0	1	0	1	0	0	1
2-5540	killing		first	year	How many ['killing'] events happened in 2015 (year) that involve the name Elizabeth (first) ?	4	1	1	0	3	2	1
2-5545	killing		first	year	How many ['killing'] events happened in 2015 (year) that involve the name Justin (first) ?	5	3	3	0	2	2	3
2-5787	killing		last	year	How many ['killing'] events happened in 2015 (year) that involve the name Jones (last) ?	10	4	3	1	7	4	3
2-5306	killing		first	year	How many ['killing'] events happened in 2015 (year) that involve the name Kevin (first) ?	8	0	0	0	8	3	0
2-5548	killing		last	year	How many ['killing'] events happened in 2015 (year) that involve the name Taylor (last) ?	4	2	1	1	3	3	2
2-6637	injuring		last	month	How many ['injuring'] events happened in 09/2016 (month) that involve the name Smith (last) ?	8	3	2	1	6	4	3
2-5789	killing		last	year	How many ['killing'] events happened in 2016 (year) that involve the name Lewis (last) ?	10	3	3	0	7	3	2
2-6878	injuring		first	year	How many ['injuring'] events happened in 2016 (year) that involve the name Marcus (first) ?	6	1	0	1	6	3	1
2-6873	injuring		first	year	How many ['injuring'] events happened in 2013 (year) that involve the name Joseph (first) ?	5	0	0	0	5	2	0
2-6630	injuring		last	month	How many ['injuring'] events happened in 12/2016 (month) that involve the name Williams (last) ?	2	1	1	0	1	2	1
2-5543	killing		first	year	How many ['killing'] events happened in 2016 (year) that involve the name George (first) ?	7	3	2	1	5	2	3
2-6632	injuring		last	month	How many ['injuring'] events happened in 09/2016 (month) that involve the name Green (last) ?	7	4	4	0	3	2	3
2-6874	injuring		first	year	How many ['injuring'] events happened in 2016 (year) that involve the name Kevin (first) ?	7	4	4	0	3	2	2
2-73	injuring	city		month	How many ['injuring'] events happened in 07/2015 (month) in ('South Carolina', 'Coward') (city) ?	0	0	0	0	0	0	0
2-72	fire_burning	city		month	How many ['fire_burning'] events happened in 03/2016 (month) in ('Wisconsin', 'Milwaukee') (city) ?	0	0	0	0	0	0	0
2-71	killing	city		month	How many ['killing'] events happened in 11/2016 (month) in ('Florida', 'Dade City') (city) ?	0	0	0	0	0	0	0
2-70	injuring	city		month	How many ['injuring'] events happened in 10/2015 (month) in ('New Jersey', 'Paterson') (city) ?	0	0	0	0	0	0	0
2-5528	killing		first	year	How many ['killing'] events happened in 2016 (year) that involve the name Linda (first) ?	4	0	0	0	4	2	0
2-6616	injuring		last	month	How many ['injuring'] events happened in 10/2016 (month) that involve the name Brown (last) ?	7	1	1	0	6	3	1
2-6858	injuring		last	year	How many ['injuring'] events happened in 2016 (year) that involve the name Robinson (last) ?	3	3	2	1	1	2	3
2-79	injuring	city		month	How many ['injuring'] events happened in 04/2013 (month) in ('Alabama', 'Mobile') (city) ?	0	0	0	0	0	0	0
2-78	injuring	city		month	How many ['injuring'] events happened in 11/2015 (month) in ('Virginia', 'Newport News') (city) ?	0	0	0	0	0	0	0
2-77	injuring	city		month	How many ['injuring'] events happened in 07/2015 (month) in ('Georgia', 'Fort Valley') (city) ?	0	0	0	0	0	0	0
2-76	injuring	city		month	How many ['injuring'] events happened in 06/2016 (month) in ('Kentucky', 'Campbellsville') (city) ?	0	0	0	0	0	0	0
2-75	injuring	city		month	How many ['injuring'] events happened in 10/2007 (month) in ('New Mexico', 'Albuquerque') (city) ?	0	0	0	0	0	0	0
2-74	killing	city		month	How many ['killing'] events happened in 08/2015 (month) in ('Texas', 'Lubbock') (city) ?	0	0	0	0	0	0	0
2-5534	killing		first	year	How many ['killing'] events happened in 2016 (year) that involve the name Michael (first) ?	6	7	3	4	3	4	6
2-6865	injuring		last	year	How many ['injuring'] events happened in 2014 (year) that involve the name Thomas (last) ?	7	1	1	0	6	3	1
2-5778	killing		last	year	How many ['killing'] events happened in 2016 (year) that involve the name Brown (last) ?	14	11	6	5	8	4	10
2-6625	injuring		last	month	How many ['injuring'] events happened in 06/2016 (month) that involve the name Brown (last) ?	9	1	1	0	8	3	1
2-6862	injuring		last	year	How many ['injuring'] events happened in 2013 (year) that involve the name Smith (last) ?	5	3	3	0	2	3	3
2-6621	injuring		last	month	How many ['injuring'] events happened in 09/2015 (month) that involve the name Smith (last) ?	4	2	1	1	3	2	2
2-84	injuring	state		day	How many ['injuring'] events happened in 14/09/2016 (day) in ('Illinois',) (state) ?	0	0	0	0	0	0	0
2-83	injuring	state		day	How many ['injuring'] events happened in 03/05/2015 (day) in ('Alabama',) (state) ?	0	0	0	0	0	0	0
2-82	fire_burning	state		day	How many ['fire_burning'] events happened in 21/11/2015 (day) in ('New York',) (state) ?	0	0	0	0	0	0	0
2-81	injuring	state		day	How many ['injuring'] events happened in 20/02/2016 (day) in ('Illinois',) (state) ?	0	0	0	0	0	0	0
2-5759	killing		last	year	How many ['killing'] events happened in 2015 (year) that involve the name Murphy (last) ?	5	4	4	0	1	2	3
2-80	killing	state		day	How many ['killing'] events happened in 19/07/2007 (day) in ('California',) (state) ?	0	0	0	0	0	0	0
2-5758	killing		last	year	How many ['killing'] events happened in 2015 (year) that involve the name Smith (last) ?	6	5	3	2	3	3	4
2-6847	injuring		last	year	How many ['injuring'] events happened in 2013 (year) that involve the name Ward (last) ?	7	1	1	0	6	2	1
2-89	injuring	state		day	How many ['injuring'] events happened in 30/08/2016 (day) in ('Florida',) (state) ?	0	0	0	0	0	0	0
2-88	killing	state		day	How many ['killing'] events happened in 04/01/2016 (day) in ('Georgia',) (state) ?	0	0	0	0	0	0	0
2-87	fire_burning	state		day	How many ['fire_burning'] events happened in 12/11/2016 (day) in ('Virginia',) (state) ?	0	0	0	0	0	0	0
2-86	injuring	state		day	How many ['injuring'] events happened in 03/08/2014 (day) in ('Michigan',) (state) ?	0	0	0	0	0	0	0
2-85	injuring	state		day	How many ['injuring'] events happened in 04/07/2015 (day) in ('Nevada',) (state) ?	0	0	0	0	0	0	0
2-5526	killing		first	year	How many ['killing'] events happened in 2016 (year) that involve the name Sean (first) ?	6	3	2	1	4	2	3
2-5525	killing		first	year	How many ['killing'] events happened in 2016 (year) that involve the name William (first) ?	7	2	2	0	5	3	2
2-5767	killing		last	year	How many ['killing'] events happened in 2016 (year) that involve the name Hall (last) ?	5	0	0	0	5	3	0
2-5762	killing		last	year	How many ['killing'] events happened in 2016 (year) that involve the name King (last) ?	4	2	1	1	3	2	2
2-6851	injuring		last	year	How many ['injuring'] events happened in 2015 (year) that involve the name Stewart (last) ?	4	1	1	0	3	2	1
2-6853	injuring		last	year	How many ['injuring'] events happened in 2015 (year) that involve the name Williams (last) ?	7	4	1	3	6	4	4
2-95	injuring	state		day	How many ['injuring'] events happened in 01/10/2015 (day) in ('Colorado',) (state) ?	0	0	0	0	0	0	0
2-94	injuring	state		day	How many ['injuring'] events happened in 02/12/2016 (day) in ('Michigan',) (state) ?	0	0	0	0	0	0	0
2-93	injuring	state		day	How many ['injuring'] events happened in 21/02/2016 (day) in ('California',) (state) ?	0	0	0	0	0	0	0
2-92	injuring	state		day	How many ['injuring'] events happened in 08/09/2008 (day) in ('Arkansas',) (state) ?	0	0	0	0	0	0	0
2-91	injuring	state		day	How many ['injuring'] events happened in 04/11/2016 (day) in ('California',) (state) ?	0	0	0	0	0	0	0
2-5989	injuring	state		year	How many ['injuring'] events happened in 2014 (year) in ('New York',) (state) ?	14	0	0	0	14	9	0
2-6836	injuring		last	year	How many ['injuring'] events happened in 2016 (year) that involve the name Hall (last) ?	4	0	0	0	4	2	0
2-90	fire_burning	state		day	How many ['fire_burning'] events happened in 29/08/2016 (day) in ('New Jersey',) (state) ?	0	0	0	0	0	0	0
2-5749	killing		last	year	How many ['killing'] events happened in 2016 (year) that involve the name Jackson (last) ?	12	11	5	6	7	5	10
2-6838	injuring		last	year	How many ['injuring'] events happened in 2016 (year) that involve the name McCray (last) ?	10	6	5	1	5	2	4
2-99	injuring	state		day	How many ['injuring'] events happened in 15/09/2013 (day) in ('Arkansas',) (state) ?	0	0	0	0	0	0	0
2-98	fire_burning	state		day	How many ['fire_burning'] events happened in 11/05/2014 (day) in ('Oklahoma',) (state) ?	0	0	0	0	0	0	0
2-97	injuring	state		day	How many ['injuring'] events happened in 04/08/2015 (day) in ('Massachusetts',) (state) ?	0	0	0	0	0	0	0
2-96	injuring	state		day	How many ['injuring'] events happened in 10/05/2014 (day) in ('Virginia',) (state) ?	0	0	0	0	0	0	0
2-5991	injuring	state		year	How many ['injuring'] events happened in 2016 (year) in ('Kansas',) (state) ?	7	10	2	8	5	6	10
2-5997	injuring	state		year	How many ['injuring'] events happened in 2013 (year) in ('North Carolina',) (state) ?	2	1	1	0	1	2	1
2-6843	injuring		last	year	How many ['injuring'] events happened in 2016 (year) that involve the name Simmons (last) ?	3	3	3	0	0	2	2
2-5999	injuring	state		year	How many ['injuring'] events happened in 2016 (year) in ('Massachusetts',) (state) ?	21	26	16	10	5	10	23
2-6604	injuring		first	month	How many ['injuring'] events happened in 09/2016 (month) that involve the name Dominique (first) ?	4	0	0	0	4	2	0
2-5993	injuring	state		year	How many ['injuring'] events happened in 2015 (year) in ('Florida',) (state) ?	32	33	26	7	6	24	32
2-5992	injuring	state		year	How many ['injuring'] events happened in 2014 (year) in ('Mississippi',) (state) ?	4	2	2	0	2	4	2
2-5511	killing		first	year	How many ['killing'] events happened in 2016 (year) that involve the name Jacob (first) ?	11	2	2	0	9	6	2
2-5510	killing		first	year	How many ['killing'] events happened in 2016 (year) that involve the name Melanie (first) ?	4	0	0	0	4	2	0
2-5752	killing		last	year	How many ['killing'] events happened in 2016 (year) that involve the name Murphy (last) ?	5	3	2	1	3	2	2
2-5994	injuring	state		year	How many ['injuring'] events happened in 2014 (year) in ('South Carolina',) (state) ?	4	5	3	2	1	3	5
2-6841	injuring		last	year	How many ['injuring'] events happened in 2016 (year) that involve the name Watson (last) ?	7	1	1	0	6	2	1
2-6829	injuring		last	year	How many ['injuring'] events happened in 2016 (year) that involve the name Marrero (last) ?	10	4	2	2	8	2	2
2-4889	killing	state		year	How many ['killing'] events happened in 2014 (year) in ('California',) (state) ?	13	12	10	2	3	10	11
2-5737	killing		last	year	How many ['killing'] events happened in 2015 (year) that involve the name Washington (last) ?	5	2	2	0	3	3	1
2-5979	injuring	state		year	How many ['injuring'] events happened in 2015 (year) in ('Arizona',) (state) ?	6	5	5	0	1	4	4
2-5978	injuring	state		year	How many ['injuring'] events happened in 2016 (year) in ('Arkansas',) (state) ?	12	22	7	15	5	7	21
2-6828	injuring		last	year	How many ['injuring'] events happened in 2013 (year) that involve the name Price (last) ?	4	0	0	0	4	2	0
2-4890	killing	state		year	How many ['killing'] events happened in 2016 (year) in ('Arizona',) (state) ?	4	4	2	2	2	4	4
2-5980	injuring	state		year	How many ['injuring'] events happened in 2016 (year) in ('Florida',) (state) ?	58	79	44	35	14	36	70
2-4891	killing	state		year	How many ['killing'] events happened in 2014 (year) in ('Washington',) (state) ?	3	6	2	4	1	2	6
2-4896	killing	state		year	How many ['killing'] events happened in 2014 (year) in ('Florida',) (state) ?	10	11	7	4	3	7	11
2-5986	injuring	state		year	How many ['injuring'] events happened in 2015 (year) in ('Iowa',) (state) ?	4	5	2	3	2	4	5
2-4897	killing	state		year	How many ['killing'] events happened in 2016 (year) in ('Georgia',) (state) ?	27	27	16	11	11	19	22
2-5501	killing		first	year	How many ['killing'] events happened in 2016 (year) that involve the name Caleb (first) ?	3	1	1	0	2	2	1
2-5985	injuring	state		year	How many ['injuring'] events happened in 2013 (year) in ('Florida',) (state) ?	10	9	8	1	2	6	8
2-6832	injuring		last	year	How many ['injuring'] events happened in 2016 (year) that involve the name Green (last) ?	9	7	7	0	2	3	5
2-5988	injuring	state		year	How many ['injuring'] events happened in 2014 (year) in ('North Carolina',) (state) ?	3	2	1	1	2	3	2
2-4899	killing	state		year	How many ['killing'] events happened in 2015 (year) in ('California',) (state) ?	26	25	22	3	4	18	24
2-5503	killing		first	year	How many ['killing'] events happened in 2016 (year) that involve the name Diego (first) ?	7	1	1	0	6	4	1
2-5987	injuring	state		year	How many ['injuring'] events happened in 2016 (year) in ('Georgia',) (state) ?	23	41	14	27	9	19	36
2-4892	killing	state		year	How many ['killing'] events happened in 2015 (year) in ('Arizona',) (state) ?	8	6	6	0	2	6	5
2-5982	injuring	state		year	How many ['injuring'] events happened in 2013 (year) in ('New Jersey',) (state) ?	7	8	6	2	1	6	8
2-4894	killing	state		year	How many ['killing'] events happened in 2015 (year) in ('Washington',) (state) ?	4	8	3	5	1	2	8
2-4895	killing	state		year	How many ['killing'] events happened in 2016 (year) in ('Hawaii',) (state) ?	5	4	4	0	1	2	3
2-5983	injuring	state		year	How many ['injuring'] events happened in 2014 (year) in ('Arkansas',) (state) ?	2	3	2	1	0	2	3
2-4878	killing	state		year	How many ['killing'] events happened in 2013 (year) in ('Tennessee',) (state) ?	6	4	4	0	2	4	4
2-5726	killing		last	year	How many ['killing'] events happened in 2016 (year) that involve the name Ramirez (last) ?	4	3	3	0	1	2	2
2-5968	injuring	state		year	How many ['injuring'] events happened in 2015 (year) in ('Wisconsin',) (state) ?	10	17	7	10	3	8	14
2-4879	killing	state		year	How many ['killing'] events happened in 2016 (year) in ('North Dakota',) (state) ?	2	1	1	0	1	2	1
2-5967	injuring	state		year	How many ['injuring'] events happened in 2016 (year) in ('Arizona',) (state) ?	9	9	5	4	4	7	9
2-5969	injuring	state		year	How many ['injuring'] events happened in 2014 (year) in ('Illinois',) (state) ?	15	7	6	1	9	11	6
2-6816	injuring		last	year	How many ['injuring'] events happened in 2016 (year) that involve the name Williams (last) ?	4	8	2	6	2	4	7
2-4880	killing	state		year	How many ['killing'] events happened in 2016 (year) in ('Florida',) (state) ?	45	51	35	16	10	25	45
2-4885	killing	state		year	How many ['killing'] events happened in 2013 (year) in ('New York',) (state) ?	9	0	0	0	9	3	0
2-5975	injuring	state		year	How many ['injuring'] events happened in 2013 (year) in ('Ohio',) (state) ?	4	7	2	5	2	3	5
2-6822	injuring		last	year	How many ['injuring'] events happened in 2015 (year) that involve the name Davis (last) ?	4	3	0	3	4	2	3
2-4886	killing	state		year	How many ['killing'] events happened in 2015 (year) in ('Georgia',) (state) ?	11	11	4	7	7	8	10
2-5735	killing		last	year	How many ['killing'] events happened in 2013 (year) that involve the name Garcia (last) ?	5	3	3	0	2	2	2
2-4888	killing	state		year	How many ['killing'] events happened in 2015 (year) in ('Michigan',) (state) ?	17	2	2	0	15	8	1
2-5734	killing		last	year	How many ['killing'] events happened in 2015 (year) that involve the name Martin (last) ?	4	0	0	0	4	2	0
2-5976	injuring	state		year	How many ['injuring'] events happened in 2015 (year) in ('New Mexico',) (state) ?	6	5	5	0	1	3	5
2-6823	injuring		last	year	How many ['injuring'] events happened in 2013 (year) that involve the name Williams (last) ?	8	3	3	0	5	4	3
2-4881	killing	state		year	How many ['killing'] events happened in 2014 (year) in ('Louisiana',) (state) ?	10	4	2	2	8	3	4
2-4882	killing	state		year	How many ['killing'] events happened in 2014 (year) in ('Texas',) (state) ?	8	6	2	4	6	6	5
2-5970	injuring	state		year	How many ['injuring'] events happened in 2014 (year) in ('Michigan',) (state) ?	12	3	3	0	9	9	3
2-4883	killing	state		year	How many ['killing'] events happened in 2016 (year) in ('Iowa',) (state) ?	12	16	9	7	3	7	15
2-5973	injuring	state		year	How many ['injuring'] events happened in 2016 (year) in ('Delaware',) (state) ?	4	26	1	25	3	3	21
2-4884	killing	state		year	How many ['killing'] events happened in 2015 (year) in ('Illinois',) (state) ?	21	10	4	6	17	10	10
2-5972	injuring	state		year	How many ['injuring'] events happened in 2016 (year) in ('Maryland',) (state) ?	25	30	15	15	10	15	25
2-6808	injuring		last	year	How many ['injuring'] events happened in 2016 (year) that involve the name Martinez (last) ?	4	5	4	1	0	2	3
2-5718	killing		last	year	How many ['killing'] events happened in 2016 (year) that involve the name Malone (last) ?	7	1	1	0	6	3	1
2-6807	injuring		last	year	How many ['injuring'] events happened in 2016 (year) that involve the name Edwards (last) ?	4	4	2	2	2	2	3
2-5715	killing		last	year	How many ['killing'] events happened in 2016 (year) that involve the name Hill (last) ?	4	2	1	1	3	2	2
2-5957	injuring	state		year	How many ['injuring'] events happened in 2013 (year) in ('New York',) (state) ?	16	0	0	0	16	7	0
2-4868	killing	state		year	How many ['killing'] events happened in 2016 (year) in ('Kentucky',) (state) ?	10	4	4	0	6	6	4
2-5956	injuring	state		year	How many ['injuring'] events happened in 2016 (year) in ('Nevada',) (state) ?	21	19	14	5	7	9	18
2-4869	killing	state		year	How many ['killing'] events happened in 2013 (year) in ('Illinois',) (state) ?	10	6	2	4	8	6	6
2-5959	injuring	state		year	How many ['injuring'] events happened in 2016 (year) in ('Illinois',) (state) ?	91	44	29	15	62	66	41
2-5958	injuring	state		year	How many ['injuring'] events happened in 2016 (year) in ('Michigan',) (state) ?	45	29	22	7	23	23	25
2-6805	injuring		last	year	How many ['injuring'] events happened in 2014 (year) that involve the name Williams (last) ?	5	5	3	2	2	3	5
2-4874	killing	state		year	How many ['killing'] events happened in 2016 (year) in ('Texas',) (state) ?	97	95	67	28	30	42	77
2-4875	killing	state		year	How many ['killing'] events happened in 2016 (year) in ('Oregon',) (state) ?	4	3	3	0	1	2	3
2-5721	killing		last	year	How many ['killing'] events happened in 2016 (year) that involve the name Thomas (last) ?	4	6	4	2	0	3	6
2-5963	injuring	state		year	How many ['injuring'] events happened in 2015 (year) in ('West Virginia',) (state) ?	2	2	2	0	0	2	2
2-4876	killing	state		year	How many ['killing'] events happened in 2016 (year) in ('Michigan',) (state) ?	51	18	10	8	41	20	17
2-5966	injuring	state		year	How many ['injuring'] events happened in 2015 (year) in ('Pennsylvania',) (state) ?	36	26	23	3	13	23	23
2-4877	killing	state		year	How many ['killing'] events happened in 2016 (year) in ('Virginia',) (state) ?	9	4	3	1	6	7	4
2-5960	injuring	state		year	How many ['injuring'] events happened in 2015 (year) in ('New York',) (state) ?	32	0	0	0	32	16	0
2-4872	killing	state		year	How many ['killing'] events happened in 2015 (year) in ('New Jersey',) (state) ?	7	4	4	0	3	5	4
2-5962	injuring	state		year	How many ['injuring'] events happened in 2013 (year) in ('District of Columbia',) (state) ?	5	9	0	9	5	2	9
2-4873	killing	state		year	How many ['killing'] events happened in 2014 (year) in ('Illinois',) (state) ?	12	7	7	0	5	8	6
2-5961	injuring	state		year	How many ['injuring'] events happened in 2016 (year) in ('North Dakota',) (state) ?	3	5	3	2	0	2	4
2-5708	killing		last	year	How many ['killing'] events happened in 2015 (year) that involve the name Brown (last) ?	11	2	2	0	9	4	2
2-5949	injuring	state		year	How many ['injuring'] events happened in 2016 (year) in ('Oklahoma',) (state) ?	2	12	1	11	1	2	9
2-101	fire_burning	state		day	How many ['fire_burning'] events happened in 18/10/2015 (day) in ('New York',) (state) ?	0	0	0	0	0	0	0
2-100	killing	state		day	How many ['killing'] events happened in 22/12/2005 (day) in ('Arkansas',) (state) ?	0	0	0	0	0	0	0
2-5946	injuring	state		day	How many ['injuring'] events happened in 18/09/2016 (day) in ('Pennsylvania',) (state) ?	3	1	1	0	2	2	1
2-4857	killing	state		year	How many ['killing'] events happened in 2015 (year) in ('Louisiana',) (state) ?	14	18	13	5	1	10	18
2-5945	injuring	state		day	How many ['injuring'] events happened in 07/11/2014 (day) in ('California',) (state) ?	2	2	2	0	0	2	2
2-4858	killing	state		year	How many ['killing'] events happened in 2016 (year) in ('Tennessee',) (state) ?	19	22	11	11	8	10	22
2-5948	injuring	state		day	How many ['injuring'] events happened in 20/04/2014 (day) in ('Illinois',) (state) ?	3	0	0	0	3	2	0
2-4859	killing	state		year	How many ['killing'] events happened in 2015 (year) in ('Kentucky',) (state) ?	8	9	5	4	3	4	7
2-5947	injuring	state		day	How many ['injuring'] events happened in 12/08/2016 (day) in ('Texas',) (state) ?	5	5	4	1	1	2	5
2-107	injuring	state		day	How many ['injuring'] events happened in 06/05/2016 (day) in ('New Jersey',) (state) ?	0	0	0	0	0	0	0
2-106	fire_burning	state		day	How many ['fire_burning'] events happened in 16/10/2014 (day) in ('California',) (state) ?	0	0	0	0	0	0	0
2-109	fire_burning	state		day	How many ['fire_burning'] events happened in 11/08/2013 (day) in ('Florida',) (state) ?	0	0	0	0	0	0	0
2-108	fire_burning	state		day	How many ['fire_burning'] events happened in 19/02/2013 (day) in ('Indiana',) (state) ?	0	0	0	0	0	0	0
2-103	injuring	state		day	How many ['injuring'] events happened in 30/04/2008 (day) in ('New York',) (state) ?	0	0	0	0	0	0	0
2-102	injuring	state		day	How many ['injuring'] events happened in 10/11/2016 (day) in ('Missouri',) (state) ?	0	0	0	0	0	0	0
2-105	injuring	state		day	How many ['injuring'] events happened in 09/09/2016 (day) in ('New Mexico',) (state) ?	0	0	0	0	0	0	0
2-104	fire_burning	state		day	How many ['fire_burning'] events happened in 04/10/2016 (day) in ('California',) (state) ?	0	0	0	0	0	0	0
2-5953	injuring	state		year	How many ['injuring'] events happened in 2015 (year) in ('Michigan',) (state) ?	26	6	3	3	23	14	5
2-4864	killing	state		year	How many ['killing'] events happened in 2014 (year) in ('Tennessee',) (state) ?	5	5	3	2	2	4	4
2-4865	killing	state		year	How many ['killing'] events happened in 2016 (year) in ('North Carolina',) (state) ?	12	11	8	3	4	7	9
2-5955	injuring	state		year	How many ['injuring'] events happened in 2015 (year) in ('Nebraska',) (state) ?	2	3	0	3	2	2	2
2-6802	injuring		last	year	How many ['injuring'] events happened in 2016 (year) that involve the name Harris (last) ?	6	0	0	0	6	2	0
2-4866	killing	state		year	How many ['killing'] events happened in 2014 (year) in ('Michigan',) (state) ?	13	1	1	0	12	9	1
2-4860	killing	state		year	How many ['killing'] events happened in 2016 (year) in ('New York',) (state) ?	32	5	5	0	27	13	4
2-5951	injuring	state		year	How many ['injuring'] events happened in 2013 (year) in ('California',) (state) ?	39	27	24	3	15	19	18
2-4862	killing	state		year	How many ['killing'] events happened in 2014 (year) in ('Georgia',) (state) ?	7	11	5	6	2	4	7
2-5950	injuring	state		year	How many ['injuring'] events happened in 2013 (year) in ('Pennsylvania',) (state) ?	12	10	8	2	4	8	10
2-110	killing		first	year	How many ['killing'] events happened in 2016 (year) that involve the name Deashaun (first) ?	5	0	0	0	5	1	0
2-4849	killing	state		year	How many ['killing'] events happened in 2013 (year) in ('Texas',) (state) ?	7	8	7	1	0	3	7
2-112	injuring		last	month	How many ['injuring'] events happened in 01/2015 (month) that involve the name Cardillo (last) ?	2	1	1	0	1	1	1
2-111	killing	city	full_name		How many ['killing'] events happened in ('Florida', 'Miami') (city) that involve the name Dravein Duke (full_name) ?	2	0	0	0	2	1	0
2-4845	killing	state		year	How many ['killing'] events happened in 2015 (year) in ('Utah',) (state) ?	3	3	3	0	0	2	2
2-4846	killing	state		year	How many ['killing'] events happened in 2016 (year) in ('Nevada',) (state) ?	12	8	8	0	4	4	7
2-4847	killing	state		year	How many ['killing'] events happened in 2014 (year) in ('South Carolina',) (state) ?	4	6	4	2	0	2	6
2-4848	killing	state		year	How many ['killing'] events happened in 2016 (year) in ('Ohio',) (state) ?	32	31	19	12	13	18	29
2-5936	injuring	state		day	How many ['injuring'] events happened in 05/11/2016 (day) in ('Texas',) (state) ?	4	4	3	1	1	2	4
2-118	killing	state		day	How many ['killing'] events happened in 09/09/2016 (day) in ('Iowa',) (state) ?	2	2	2	0	0	1	2
2-117	killing		last	month	How many ['killing'] events happened in 09/2016 (month) that involve the name Moise (last) ?	3	2	2	0	1	1	1
2-119	killing		first	month	How many ['killing'] events happened in 03/2014 (month) that involve the name Brady (first) ?	3	0	0	0	3	1	0
2-114	injuring		last	year	How many ['injuring'] events happened in 2016 (year) that involve the name Barkley (last) ?	2	0	0	0	2	1	0
2-113	injuring		full_name	year	How many ['injuring'] events happened in 2016 (year) that involve the name Derico Clark (full_name) ?	2	0	0	0	2	1	0
2-116	killing		full_name	day	How many ['killing'] events happened in 13/03/2015 (day) that involve the name Victoria Sims (full_name) ?	2	1	1	0	1	1	1
2-115	killing	city	last		How many ['killing'] events happened in ('Texas', 'Longview') (city) that involve the name Gonzales (last) ?	2	0	0	0	2	1	0
2-5702	killing		last	year	How many ['killing'] events happened in 2016 (year) that involve the name Reed (last) ?	4	1	1	0	3	2	1
2-4855	killing	state		year	How many ['killing'] events happened in 2014 (year) in ('Ohio',) (state) ?	2	1	1	0	1	2	1
2-5943	injuring	state		day	How many ['injuring'] events happened in 26/09/2016 (day) in ('Texas',) (state) ?	11	8	7	1	4	2	8
2-4850	killing	state		year	How many ['killing'] events happened in 2016 (year) in ('Connecticut',) (state) ?	5	4	2	2	3	2	4
2-4851	killing	state		year	How many ['killing'] events happened in 2016 (year) in ('Louisiana',) (state) ?	27	33	22	11	5	14	27
2-4838	killing	state		year	How many ['killing'] events happened in 2016 (year) in ('California',) (state) ?	55	48	41	7	14	34	44
2-5928	injuring	state		day	How many ['injuring'] events happened in 14/10/2016 (day) in ('Illinois',) (state) ?	3	0	0	0	3	2	0
2-4839	killing	state		year	How many ['killing'] events happened in 2016 (year) in ('South Carolina',) (state) ?	15	16	9	7	6	10	13
2-5929	injuring	state		day	How many ['injuring'] events happened in 25/10/2015 (day) in ('Arizona',) (state) ?	3	2	2	0	1	2	2
2-4834	killing	state		year	How many ['killing'] events happened in 2016 (year) in ('Illinois',) (state) ?	59	30	23	7	36	34	27
2-4835	killing	state		year	How many ['killing'] events happened in 2016 (year) in ('Washington',) (state) ?	15	14	6	8	9	5	14
2-4836	killing	state		year	How many ['killing'] events happened in 2015 (year) in ('Ohio',) (state) ?	19	12	7	5	12	10	11
2-4837	killing	state		year	How many ['killing'] events happened in 2013 (year) in ('Florida',) (state) ?	6	7	5	2	1	3	7
2-5925	injuring	state		day	How many ['injuring'] events happened in 14/06/2016 (day) in ('Delaware',) (state) ?	3	1	1	0	2	2	1
2-4841	killing	state		year	How many ['killing'] events happened in 2013 (year) in ('Michigan',) (state) ?	4	0	0	0	4	2	0
2-5931	injuring	state		day	How many ['injuring'] events happened in 13/12/2015 (day) in ('California',) (state) ?	3	2	2	0	1	2	2
2-4842	killing	state		year	How many ['killing'] events happened in 2013 (year) in ('Kentucky',) (state) ?	2	2	2	0	0	2	2
2-4843	killing	state		year	How many ['killing'] events happened in 2013 (year) in ('Oklahoma',) (state) ?	5	5	5	0	0	2	5
2-4844	killing	state		year	How many ['killing'] events happened in 2016 (year) in ('Massachusetts',) (state) ?	13	14	11	3	2	4	12
2-4840	killing	state		year	How many ['killing'] events happened in 2014 (year) in ('Arizona',) (state) ?	2	2	1	1	1	2	2
2-4827	killing	state		year	How many ['killing'] events happened in 2015 (year) in ('New Mexico',) (state) ?	6	4	4	0	2	3	4
2-4828	killing	state		year	How many ['killing'] events happened in 2015 (year) in ('Texas',) (state) ?	29	34	19	15	10	15	32
2-4825	killing	state		year	How many ['killing'] events happened in 2016 (year) in ('Colorado',) (state) ?	20	17	14	3	6	9	15
2-4826	killing	state		year	How many ['killing'] events happened in 2015 (year) in ('Kansas',) (state) ?	3	4	2	2	1	2	3
2-4831	killing	state		year	How many ['killing'] events happened in 2015 (year) in ('Wisconsin',) (state) ?	6	5	3	2	3	4	5
2-4833	killing	state		year	How many ['killing'] events happened in 2016 (year) in ('Maryland',) (state) ?	15	22	11	11	4	8	18
2-4816	killing	state		year	How many ['killing'] events happened in 2015 (year) in ('Alabama',) (state) ?	2	1	1	0	1	2	1
2-4817	killing	state		year	How many ['killing'] events happened in 2015 (year) in ('Tennessee',) (state) ?	15	10	8	2	7	8	8
2-5905	killing	state	last		How many ['killing'] events happened in ('Ohio',) (state) that involve the name Green (last) ?	4	0	0	0	4	2	0
2-5902	killing	state	last		How many ['killing'] events happened in ('Florida',) (state) that involve the name Wright (last) ?	3	0	0	0	3	2	0
2-4813	killing	state		year	How many ['killing'] events happened in 2013 (year) in ('California',) (state) ?	19	15	15	0	4	9	10
2-5901	killing	state	last		How many ['killing'] events happened in ('Texas',) (state) that involve the name Howard (last) ?	8	1	1	0	7	2	1
2-4815	killing	state		year	How many ['killing'] events happened in 2014 (year) in ('New Jersey',) (state) ?	2	1	1	0	1	2	1
2-5909	killing	state	last		How many ['killing'] events happened in ('Illinois',) (state) that involve the name Brown (last) ?	7	1	1	0	6	3	1
2-7090	injuring	city	last		How many ['injuring'] events happened in ('Tennessee', 'Memphis') (city) that involve the name Malone (last) ?	4	0	0	0	4	2	0
2-7099	fire_burning	state		year	How many ['fire_burning'] events happened in 2008 (year) in ('Florida',) (state) ?	3	3	3	0	0	3	3
2-7097	fire_burning	state		year	How many ['fire_burning'] events happened in 2006 (year) in ('Texas',) (state) ?	3	2	2	0	1	3	2
2-7098	fire_burning	state		year	How many ['fire_burning'] events happened in 2006 (year) in ('Tennessee',) (state) ?	2	1	1	0	1	2	1
2-4820	killing	state		year	How many ['killing'] events happened in 2016 (year) in ('Pennsylvania',) (state) ?	41	44	32	12	9	19	39
2-4821	killing	state		year	How many ['killing'] events happened in 2015 (year) in ('Florida',) (state) ?	21	19	14	5	7	12	18
2-4822	killing	state		year	How many ['killing'] events happened in 2015 (year) in ('Maryland',) (state) ?	6	8	4	4	2	6	8
2-4805	killing	state		year	How many ['killing'] events happened in 2013 (year) in ('Kansas',) (state) ?	4	3	2	1	2	2	3
2-4806	killing	state		year	How many ['killing'] events happened in 2013 (year) in ('Maryland',) (state) ?	8	9	6	3	2	3	9
2-4807	killing	state		year	How many ['killing'] events happened in 2016 (year) in ('Alabama',) (state) ?	12	9	4	5	8	10	9
2-4808	killing	state		year	How many ['killing'] events happened in 2015 (year) in ('Pennsylvania',) (state) ?	13	15	7	8	6	7	14
2-4801	killing	state		year	How many ['killing'] events happened in 2014 (year) in ('Virginia',) (state) ?	5	3	3	0	2	3	3
2-4802	killing	state		year	How many ['killing'] events happened in 2015 (year) in ('Mississippi',) (state) ?	4	2	1	1	3	2	2
2-4804	killing	state		year	How many ['killing'] events happened in 2015 (year) in ('Oklahoma',) (state) ?	5	2	2	0	3	3	2
2-7082	injuring	state	last		How many ['injuring'] events happened in ('Michigan',) (state) that involve the name Williams (last) ?	4	0	0	0	4	2	0
2-7080	injuring	state	last		How many ['injuring'] events happened in ('Florida',) (state) that involve the name Thompson (last) ?	4	1	1	0	3	2	1
2-7081	injuring	state	last		How many ['injuring'] events happened in ('California',) (state) that involve the name Taylor (last) ?	4	0	0	0	4	2	0
2-4809	killing	state		year	How many ['killing'] events happened in 2016 (year) in ('New Jersey',) (state) ?	22	17	16	1	6	11	12
2-7086	injuring	state	last		How many ['injuring'] events happened in ('Tennessee',) (state) that involve the name Smith (last) ?	5	0	0	0	5	2	0
2-7087	injuring	state	last		How many ['injuring'] events happened in ('Maryland',) (state) that involve the name Jones (last) ?	7	2	2	0	5	3	2
2-7084	injuring	state	last		How many ['injuring'] events happened in ('Florida',) (state) that involve the name Wright (last) ?	3	0	0	0	3	2	0
2-4810	killing	state		year	How many ['killing'] events happened in 2015 (year) in ('North Carolina',) (state) ?	5	8	5	3	0	4	8
2-5900	killing	state	last		How many ['killing'] events happened in ('California',) (state) that involve the name Smith (last) ?	5	5	4	1	1	2	4
2-4811	killing	state		year	How many ['killing'] events happened in 2014 (year) in ('Indiana',) (state) ?	5	5	3	2	2	5	5
2-7070	injuring	state	first		How many ['injuring'] events happened in ('Texas',) (state) that involve the name Adrian (first) ?	7	1	1	0	6	2	1
2-7077	injuring	state	last		How many ['injuring'] events happened in ('Ohio',) (state) that involve the name Smith (last) ?	5	3	1	2	4	2	2
2-7078	injuring	state	last		How many ['injuring'] events happened in ('Pennsylvania',) (state) that involve the name Brown (last) ?	3	0	0	0	3	2	0
2-7075	injuring	state	last		How many ['injuring'] events happened in ('Arkansas',) (state) that involve the name Williams (last) ?	3	1	1	0	2	2	1
2-7074	injuring	state	last		How many ['injuring'] events happened in ('Pennsylvania',) (state) that involve the name Jones (last) ?	7	0	0	0	7	2	0
2-7069	injuring	state	first		How many ['injuring'] events happened in ('Tennessee',) (state) that involve the name Robert (first) ?	2	1	1	0	1	2	1
2-7066	injuring	state	first		How many ['injuring'] events happened in ('Florida',) (state) that involve the name David (first) ?	3	0	0	0	3	2	0
2-7067	injuring	state	first		How many ['injuring'] events happened in ('Pennsylvania',) (state) that involve the name Stephen (first) ?	6	1	0	1	6	2	1
2-7065	injuring	state	first		How many ['injuring'] events happened in ('Indiana',) (state) that involve the name Andrew (first) ?	3	0	0	0	3	2	0
2-7063	injuring	state	first		How many ['injuring'] events happened in ('Louisiana',) (state) that involve the name Corey (first) ?	11	0	0	0	11	2	0
2-7058	injuring		first	year	How many ['injuring'] events happened in 2016 (year) that involve the name Emma (first) ?	5	2	2	0	3	2	2
2-7054	injuring		first	year	How many ['injuring'] events happened in 2016 (year) that involve the name Anthony (first) ?	10	4	1	3	9	4	4
2-7051	injuring		first	year	How many ['injuring'] events happened in 2013 (year) that involve the name Brandon (first) ?	4	1	1	0	3	3	1
2-6190	injuring	state		month	How many ['injuring'] events happened in 09/2015 (month) in ('Illinois',) (state) ?	11	2	1	1	10	7	2
2-7046	injuring		first	year	How many ['injuring'] events happened in 2016 (year) that involve the name Lawrence (first) ?	5	1	0	1	5	2	1
2-7044	injuring		first	year	How many ['injuring'] events happened in 2016 (year) that involve the name Stephon (first) ?	4	1	1	0	3	2	1
2-6199	injuring	state		month	How many ['injuring'] events happened in 03/2016 (month) in ('California',) (state) ?	7	4	4	0	3	4	4
2-6193	injuring	state		month	How many ['injuring'] events happened in 07/2016 (month) in ('Florida',) (state) ?	5	7	2	5	3	3	6
2-5090	killing	state		month	How many ['killing'] events happened in 04/2016 (month) in ('Maryland',) (state) ?	5	6	5	1	0	2	4
2-5092	killing	state		month	How many ['killing'] events happened in 12/2016 (month) in ('Alabama',) (state) ?	2	0	0	0	2	2	0
2-6180	injuring	state		month	How many ['injuring'] events happened in 08/2016 (month) in ('Connecticut',) (state) ?	10	6	6	0	4	3	4
2-6187	injuring	state		month	How many ['injuring'] events happened in 05/2016 (month) in ('Tennessee',) (state) ?	8	5	5	0	3	3	5
2-5097	killing	state		month	How many ['killing'] events happened in 08/2014 (month) in ('Oklahoma',) (state) ?	2	2	2	0	0	2	2
2-7036	injuring		first	year	How many ['injuring'] events happened in 2013 (year) that involve the name Christopher (first) ?	3	1	1	0	2	2	1
2-6189	injuring	state		month	How many ['injuring'] events happened in 06/2016 (month) in ('Minnesota',) (state) ?	3	4	3	1	0	2	4
2-7031	injuring		first	year	How many ['injuring'] events happened in 2016 (year) that involve the name Gregory (first) ?	7	3	3	0	4	2	2
2-7030	injuring		first	year	How many ['injuring'] events happened in 2015 (year) that involve the name Marquise (first) ?	6	2	2	0	4	2	2
2-7038	injuring		first	year	How many ['injuring'] events happened in 2013 (year) that involve the name William (first) ?	5	2	2	0	3	2	2
2-7024	injuring		first	year	How many ['injuring'] events happened in 2016 (year) that involve the name Michael (first) ?	4	6	0	6	4	2	6
2-5086	killing	state		month	How many ['killing'] events happened in 11/2016 (month) in ('Louisiana',) (state) ?	11	8	8	0	3	3	6
2-6178	injuring	state		month	How many ['injuring'] events happened in 11/2016 (month) in ('Tennessee',) (state) ?	6	5	4	1	2	3	5
2-7022	injuring		first	year	How many ['injuring'] events happened in 2016 (year) that involve the name Timothy (first) ?	7	4	2	2	5	2	3
2-5088	killing	state		month	How many ['killing'] events happened in 10/2016 (month) in ('Georgia',) (state) ?	6	4	4	0	2	5	3
2-6177	injuring	state		month	How many ['injuring'] events happened in 06/2015 (month) in ('Michigan',) (state) ?	5	3	1	2	4	3	2
2-5082	killing	state		month	How many ['killing'] events happened in 03/2016 (month) in ('Texas',) (state) ?	4	7	4	3	0	3	6
2-6174	injuring	state		month	How many ['injuring'] events happened in 09/2016 (month) in ('Illinois',) (state) ?	12	9	7	2	5	5	9
2-5084	killing	state		month	How many ['killing'] events happened in 01/2015 (month) in ('California',) (state) ?	7	7	7	0	0	5	6
2-7013	injuring		first	year	How many ['injuring'] events happened in 2016 (year) that involve the name Dominique (first) ?	7	1	1	0	6	3	1
2-6164	injuring	state		month	How many ['injuring'] events happened in 06/2016 (month) in ('Texas',) (state) ?	4	12	3	9	1	2	8
2-5078	killing	state		month	How many ['killing'] events happened in 02/2015 (month) in ('Texas',) (state) ?	6	6	4	2	2	4	6
2-7011	injuring		first	year	How many ['injuring'] events happened in 2013 (year) that involve the name Darren (first) ?	2	0	0	0	2	2	0
2-5077	killing	state		month	How many ['killing'] events happened in 11/2016 (month) in ('Illinois',) (state) ?	13	7	6	1	7	9	6
2-5074	killing	state		month	How many ['killing'] events happened in 01/2016 (month) in ('Georgia',) (state) ?	3	2	2	0	1	2	2
2-6163	injuring	state		month	How many ['injuring'] events happened in 07/2016 (month) in ('Louisiana',) (state) ?	5	5	2	3	3	2	5
2-6162	injuring	state		month	How many ['injuring'] events happened in 12/2016 (month) in ('Alabama',) (state) ?	3	1	1	0	2	3	1
2-6168	injuring	state		month	How many ['injuring'] events happened in 01/2016 (month) in ('Virginia',) (state) ?	3	1	1	0	2	2	1
2-7016	injuring		first	year	How many ['injuring'] events happened in 2015 (year) that involve the name Brandon (first) ?	3	1	1	0	2	2	1
2-7002	injuring		first	year	How many ['injuring'] events happened in 2016 (year) that involve the name Tyler (first) ?	4	1	1	0	3	2	1
2-6153	injuring	city		month	How many ['injuring'] events happened in 07/2015 (month) in ('Kentucky', 'Louisville') (city) ?	6	0	0	0	6	2	0
2-5066	killing	state		month	How many ['killing'] events happened in 09/2015 (month) in (None,) (state) ?	2	0	0	0	2	2	0
2-6150	injuring	city		month	How many ['injuring'] events happened in 02/2016 (month) in ('Virginia', 'Portsmouth') (city) ?	3	3	3	0	0	2	3
2-6392	injuring	state		month	How many ['injuring'] events happened in 07/2014 (month) in ('Pennsylvania',) (state) ?	3	2	2	0	1	3	2
2-6394	injuring	state		month	How many ['injuring'] events happened in 01/2015 (month) in ('Virginia',) (state) ?	2	1	1	0	1	2	1
2-7008	injuring		first	year	How many ['injuring'] events happened in 2015 (year) that involve the name Robert (first) ?	3	1	0	1	3	2	1
2-6157	injuring	city		month	How many ['injuring'] events happened in 12/2015 (month) in ('Louisiana', 'New Orleans') (city) ?	2	2	2	0	0	2	2
2-7007	injuring		first	year	How many ['injuring'] events happened in 2015 (year) that involve the name David (first) ?	5	1	0	1	5	2	1
2-6159	injuring	state		month	How many ['injuring'] events happened in 06/2015 (month) in ('Texas',) (state) ?	4	5	2	3	2	2	4
2-6143	injuring	city		month	How many ['injuring'] events happened in 11/2016 (month) in ('Texas', 'San Antonio') (city) ?	4	4	4	0	0	2	4
2-6385	injuring	state		month	How many ['injuring'] events happened in 07/2016 (month) in ('Texas',) (state) ?	25	30	19	11	6	9	22
2-5053	killing	state		month	How many ['killing'] events happened in 09/2016 (month) in ('South Carolina',) (state) ?	5	4	2	2	3	2	2
2-5056	killing	state		month	How many ['killing'] events happened in 03/2016 (month) in ('Montana',) (state) ?	3	3	2	1	1	2	3
2-6145	injuring	city		month	How many ['injuring'] events happened in 07/2015 (month) in ('Texas', 'Dallas') (city) ?	3	1	1	0	2	2	1
2-6387	injuring	state		month	How many ['injuring'] events happened in 10/2016 (month) in ('California',) (state) ?	22	17	16	1	6	11	15
2-5297	killing		first	year	How many ['killing'] events happened in 2016 (year) that involve the name Ryan (first) ?	5	4	4	0	1	2	2
2-6386	injuring	state		month	How many ['injuring'] events happened in 09/2015 (month) in ('Florida',) (state) ?	3	3	2	1	1	2	3
2-5052	killing	state		month	How many ['killing'] events happened in 11/2015 (month) in ('Arkansas',) (state) ?	9	9	8	1	1	4	9
2-5299	killing		first	year	How many ['killing'] events happened in 2016 (year) that involve the name Brandon (first) ?	6	0	0	0	6	4	0
2-6146	injuring	city		month	How many ['injuring'] events happened in 07/2016 (month) in ('Ohio', 'Cleveland') (city) ?	2	1	1	0	1	2	1
2-6388	injuring	state		month	How many ['injuring'] events happened in 10/2016 (month) in ('Texas',) (state) ?	9	19	8	11	1	3	15
2-5059	killing	state		month	How many ['killing'] events happened in 05/2016 (month) in ('Alabama',) (state) ?	3	1	1	0	2	3	1
2-6374	injuring	state		month	How many ['injuring'] events happened in 03/2016 (month) in ('Georgia',) (state) ?	7	6	4	2	3	6	6
2-6373	injuring	state		month	How many ['injuring'] events happened in 12/2016 (month) in ('California',) (state) ?	10	9	6	3	4	4	9
2-5286	killing		first	year	How many ['killing'] events happened in 2015 (year) that involve the name Shawn (first) ?	3	3	3	0	0	2	3
2-6133	injuring	city		month	How many ['injuring'] events happened in 10/2016 (month) in ('Louisiana', 'Shreveport') (city) ?	3	4	3	1	0	2	4
2-6375	injuring	state		month	How many ['injuring'] events happened in 02/2013 (month) in ('California',) (state) ?	11	8	8	0	3	3	3
2-6372	injuring	state		month	How many ['injuring'] events happened in 09/2016 (month) in ('Wisconsin',) (state) ?	3	4	2	2	1	2	4
2-5040	killing	state		month	How many ['killing'] events happened in 11/2016 (month) in ('Virginia',) (state) ?	5	2	2	0	3	3	2
2-5282	killing		first	year	How many ['killing'] events happened in 2016 (year) that involve the name Naome (first) ?	2	0	0	0	2	2	0
2-6371	injuring	state		month	How many ['injuring'] events happened in 10/2015 (month) in ('Arizona',) (state) ?	5	4	4	0	1	3	3
2-6136	injuring	city		month	How many ['injuring'] events happened in 05/2014 (month) in ('California', 'Sacramento') (city) ?	2	2	2	0	0	2	2
2-5046	killing	state		month	How many ['killing'] events happened in 10/2015 (month) in ('Arizona',) (state) ?	4	3	3	0	1	2	2
2-6135	injuring	city		month	How many ['injuring'] events happened in 10/2015 (month) in ('Maryland', 'Baltimore') (city) ?	3	3	3	0	0	2	3
2-6137	injuring	city		month	How many ['injuring'] events happened in 11/2015 (month) in ('California', 'Fresno') (city) ?	3	0	0	0	3	2	0
2-5032	killing	state		month	How many ['killing'] events happened in 11/2016 (month) in ('Pennsylvania',) (state) ?	8	7	5	2	3	4	7
2-5274	killing		first	year	How many ['killing'] events happened in 2016 (year) that involve the name Christopher (first) ?	20	11	8	3	12	11	10
2-6121	injuring	city		month	How many ['injuring'] events happened in 10/2016 (month) in ('California', 'Fresno') (city) ?	3	1	1	0	2	2	1
2-5031	killing	state		month	How many ['killing'] events happened in 04/2016 (month) in ('Wisconsin',) (state) ?	5	5	5	0	0	4	4
2-6365	injuring	state		month	How many ['injuring'] events happened in 11/2015 (month) in ('Washington',) (state) ?	7	5	5	0	2	2	5
2-5033	killing	state		month	How many ['killing'] events happened in 11/2016 (month) in ('New York',) (state) ?	7	3	3	0	4	3	3
2-6122	injuring	city		month	How many ['injuring'] events happened in 07/2015 (month) in ('Missouri', 'Saint Louis') (city) ?	2	0	0	0	2	2	0
2-5036	killing	state		month	How many ['killing'] events happened in 02/2013 (month) in ('California',) (state) ?	8	6	6	0	2	2	2
2-6125	injuring	city		month	How many ['injuring'] events happened in 07/2016 (month) in ('Texas', 'Houston') (city) ?	6	9	6	3	0	2	8
2-6366	injuring	state		month	How many ['injuring'] events happened in 09/2016 (month) in ('Michigan',) (state) ?	9	7	7	0	2	2	6
2-6369	injuring	state		month	How many ['injuring'] events happened in 07/2015 (month) in ('Iowa',) (state) ?	2	1	0	1	2	2	1
2-5021	killing	state		month	How many ['killing'] events happened in 10/2016 (month) in ('South Carolina',) (state) ?	2	1	1	0	1	2	1
2-5263	killing		last	month	How many ['killing'] events happened in 07/2016 (month) that involve the name Rodriguez (last) ?	4	4	4	0	0	2	2
2-6110	injuring	city		month	How many ['injuring'] events happened in 04/2016 (month) in ('Nevada', 'Las Vegas') (city) ?	5	3	3	0	2	2	3
2-6594	injuring		first	month	How many ['injuring'] events happened in 10/2016 (month) that involve the name James (first) ?	4	0	0	0	4	2	0
2-6596	injuring		first	month	How many ['injuring'] events happened in 06/2016 (month) that involve the name Eric (first) ?	7	1	1	0	6	2	1
2-5264	killing		first	year	How many ['killing'] events happened in 2016 (year) that involve the name Maurice (first) ?	6	1	0	1	6	2	1
2-6111	injuring	city		month	How many ['injuring'] events happened in 11/2015 (month) in ('Indiana', 'Indianapolis') (city) ?	4	1	1	0	3	2	1
2-6353	injuring	state		month	How many ['injuring'] events happened in 05/2016 (month) in ('South Carolina',) (state) ?	6	5	5	0	1	3	4
2-5261	killing		last	month	How many ['killing'] events happened in 04/2015 (month) that involve the name Clayton (last) ?	5	1	1	0	4	2	1
2-6350	injuring	state		month	How many ['injuring'] events happened in 08/2015 (month) in ('Illinois',) (state) ?	6	5	3	2	3	5	5
2-6592	injuring		first	month	How many ['injuring'] events happened in 11/2015 (month) that involve the name Joseph (first) ?	2	1	1	0	1	2	1
2-6591	injuring		first	month	How many ['injuring'] events happened in 11/2016 (month) that involve the name Christopher (first) ?	3	4	3	1	0	2	3
2-5029	killing	state		month	How many ['killing'] events happened in 08/2016 (month) in ('Illinois',) (state) ?	4	0	0	0	4	2	0
2-6119	injuring	city		month	How many ['injuring'] events happened in 08/2016 (month) in ('Texas', 'Dallas') (city) ?	6	4	4	0	2	2	4
2-5027	killing	state		month	How many ['killing'] events happened in 09/2016 (month) in ('Illinois',) (state) ?	10	6	5	1	5	4	6
2-6115	injuring	city		month	How many ['injuring'] events happened in 03/2016 (month) in ('Georgia', 'Savannah') (city) ?	2	1	1	0	1	2	1
2-5010	killing	state		month	How many ['killing'] events happened in 11/2016 (month) in ('Kentucky',) (state) ?	6	4	4	0	2	3	4
2-6583	injuring	city		year	How many ['injuring'] events happened in 2016 (year) in ('Wisconsin', 'Milwaukee') (city) ?	7	11	6	5	1	6	10
2-6340	injuring	state		month	How many ['injuring'] events happened in 11/2014 (month) in ('California',) (state) ?	5	4	4	0	1	5	4
2-5496	killing		first	year	How many ['killing'] events happened in 2016 (year) that involve the name Bryant (first) ?	3	1	0	1	3	2	1
2-6343	injuring	state		month	How many ['injuring'] events happened in 04/2016 (month) in ('Michigan',) (state) ?	7	1	1	0	6	4	1
2-5495	killing		first	year	How many ['killing'] events happened in 2016 (year) that involve the name Katie (first) ?	4	1	1	0	3	2	1
2-6342	injuring	state		month	How many ['injuring'] events happened in 10/2016 (month) in ('Arizona',) (state) ?	2	1	1	0	1	2	1
2-6584	injuring	city		year	How many ['injuring'] events happened in 2013 (year) in ('Indiana', 'Indianapolis') (city) ?	5	1	1	0	4	3	1
2-5250	killing		last	month	How many ['killing'] events happened in 11/2015 (month) that involve the name Edwards (last) ?	6	0	0	0	6	2	0
2-5492	killing		first	year	How many ['killing'] events happened in 2016 (year) that involve the name Rafael (first) ?	3	1	1	0	2	2	1
2-6581	injuring	city		year	How many ['injuring'] events happened in 2015 (year) in ('New York', 'New York (Manhattan)') (city) ?	5	8	2	6	3	2	7
2-6107	injuring	city		month	How many ['injuring'] events happened in 05/2016 (month) in ('Maryland', 'Baltimore') (city) ?	3	0	0	0	3	2	0
2-6349	injuring	state		month	How many ['injuring'] events happened in 08/2015 (month) in ('New York',) (state) ?	5	0	0	0	5	2	0
2-6106	injuring	city		month	How many ['injuring'] events happened in 12/2015 (month) in ('Texas', 'Houston') (city) ?	2	2	2	0	0	2	2
2-6348	injuring	state		month	How many ['injuring'] events happened in 11/2014 (month) in ('Florida',) (state) ?	2	1	1	0	1	2	1
2-6109	injuring	city		month	How many ['injuring'] events happened in 07/2016 (month) in ('Maryland', 'Baltimore') (city) ?	3	1	0	1	3	2	1
2-5498	killing		first	year	How many ['killing'] events happened in 2015 (year) that involve the name Marcus (first) ?	2	2	1	1	1	2	2
2-6587	injuring		first	month	How many ['injuring'] events happened in 09/2016 (month) that involve the name Anthony (first) ?	5	0	0	0	5	2	0
2-5255	killing		last	month	How many ['killing'] events happened in 12/2015 (month) that involve the name Williams (last) ?	2	0	0	0	2	2	0
2-6102	injuring	city		month	How many ['injuring'] events happened in 07/2014 (month) in ('Virginia', 'Norfolk') (city) ?	2	0	0	0	2	2	0
2-6104	injuring	city		month	How many ['injuring'] events happened in 04/2016 (month) in ('Wisconsin', 'Milwaukee') (city) ?	2	3	2	1	0	2	3
2-6330	injuring	state		month	How many ['injuring'] events happened in 01/2016 (month) in ('Nevada',) (state) ?	8	4	4	0	4	2	4
2-6572	injuring	city		year	How many ['injuring'] events happened in 2015 (year) in ('Louisiana', 'New Orleans') (city) ?	6	5	5	0	1	5	5
2-5240	killing		last	month	How many ['killing'] events happened in 11/2015 (month) that involve the name Taylor (last) ?	2	1	1	0	1	2	1
2-6574	injuring	city		year	How many ['injuring'] events happened in 2014 (year) in ('Georgia', 'Atlanta') (city) ?	9	5	5	0	4	5	3
2-6331	injuring	state		month	How many ['injuring'] events happened in 09/2015 (month) in ('Pennsylvania',) (state) ?	4	2	2	0	2	3	1
2-6573	injuring	city		year	How many ['injuring'] events happened in 2016 (year) in ('Louisiana', 'Shreveport') (city) ?	4	14	4	10	0	3	14
2-5249	killing		last	month	How many ['killing'] events happened in 09/2016 (month) that involve the name Williams (last) ?	3	2	2	0	1	2	2
2-6338	injuring	state		month	How many ['injuring'] events happened in 12/2014 (month) in ('Illinois',) (state) ?	4	2	2	0	2	2	1
2-6337	injuring	state		month	How many ['injuring'] events happened in 06/2016 (month) in ('North Carolina',) (state) ?	4	1	1	0	3	3	1
2-6579	injuring	city		year	How many ['injuring'] events happened in 2016 (year) in ('Texas', 'Lubbock') (city) ?	3	3	3	0	0	3	3
2-5009	killing	state		month	How many ['killing'] events happened in 12/2016 (month) in ('Colorado',) (state) ?	4	2	2	0	2	2	2
2-5003	killing	state		month	How many ['killing'] events happened in 08/2016 (month) in ('Wisconsin',) (state) ?	3	4	3	1	0	2	3
2-5487	killing		first	year	How many ['killing'] events happened in 2016 (year) that involve the name Kenneth (first) ?	5	4	4	0	1	3	3
2-6576	injuring	city		year	How many ['injuring'] events happened in 2015 (year) in ('Florida', 'Orlando') (city) ?	2	0	0	0	2	2	0
2-5002	killing	state		month	How many ['killing'] events happened in 09/2016 (month) in ('Indiana',) (state) ?	5	4	4	0	1	2	3
2-6575	injuring	city		year	How many ['injuring'] events happened in 2015 (year) in ('Georgia', 'Savannah') (city) ?	2	0	0	0	2	2	0
2-6336	injuring	state		month	How many ['injuring'] events happened in 04/2016 (month) in ('Illinois',) (state) ?	8	1	1	0	7	7	1
2-5472	killing		first	year	How many ['killing'] events happened in 2015 (year) that involve the name Alexis (first) ?	2	0	0	0	2	2	0
2-6561	injuring	city		year	How many ['injuring'] events happened in 2013 (year) in ('California', 'Vallejo') (city) ?	7	2	2	0	5	4	1
2-6320	injuring	state		month	How many ['injuring'] events happened in 03/2014 (month) in ('California',) (state) ?	3	3	3	0	0	2	3
2-6562	injuring	city		year	How many ['injuring'] events happened in 2016 (year) in ('Minnesota', 'Minneapolis') (city) ?	9	9	8	1	1	5	9
2-6569	injuring	city		year	How many ['injuring'] events happened in 2015 (year) in ('Missouri', 'Kansas City') (city) ?	4	3	1	2	3	2	3
2-6326	injuring	state		month	How many ['injuring'] events happened in 08/2016 (month) in ('New Jersey',) (state) ?	6	2	2	0	4	3	2
2-6568	injuring	city		year	How many ['injuring'] events happened in 2016 (year) in ('Ohio', 'Columbus') (city) ?	5	7	2	5	3	4	5
2-6328	injuring	state		month	How many ['injuring'] events happened in 10/2016 (month) in ('Virginia',) (state) ?	2	0	0	0	2	2	0
2-6565	injuring	city		year	How many ['injuring'] events happened in 2015 (year) in ('Pennsylvania', 'Pittsburgh') (city) ?	5	11	4	7	1	4	9
2-6564	injuring	city		year	How many ['injuring'] events happened in 2016 (year) in ('Ohio', 'Dayton') (city) ?	4	2	2	0	2	2	2
2-5236	killing		last	month	How many ['killing'] events happened in 03/2016 (month) that involve the name Jackson (last) ?	4	5	2	3	2	2	4
2-5478	killing		first	year	How many ['killing'] events happened in 2015 (year) that involve the name Ryan (first) ?	3	4	1	3	2	2	4
2-6567	injuring	city		year	How many ['injuring'] events happened in 2015 (year) in ('Louisiana', 'Baton Rouge') (city) ?	3	4	3	1	0	2	4
2-6324	injuring	state		month	How many ['injuring'] events happened in 07/2016 (month) in ('Washington',) (state) ?	4	6	4	2	0	2	6
2-6309	injuring	state		month	How many ['injuring'] events happened in 07/2015 (month) in ('Louisiana',) (state) ?	3	6	3	3	0	2	6
2-6308	injuring	state		month	How many ['injuring'] events happened in 07/2016 (month) in ('Ohio',) (state) ?	6	7	4	3	2	4	6
2-6550	injuring	city		year	How many ['injuring'] events happened in 2016 (year) in ('Arizona', 'Tucson') (city) ?	3	4	3	1	0	2	4
2-5463	killing		first	year	How many ['killing'] events happened in 2016 (year) that involve the name Kelvin (first) ?	7	4	4	0	3	2	3
2-6552	injuring	city		year	How many ['injuring'] events happened in 2015 (year) in ('Texas', 'San Antonio') (city) ?	7	2	2	0	5	2	2
2-5220	killing		last	month	How many ['killing'] events happened in 12/2016 (month) that involve the name Johnson (last) ?	13	4	4	0	9	4	3
2-6551	injuring	city		year	How many ['injuring'] events happened in 2015 (year) in ('Arkansas', 'Little Rock') (city) ?	3	8	3	5	0	2	7
2-6558	injuring	city		year	How many ['injuring'] events happened in 2013 (year) in ('California', 'Oakland') (city) ?	5	0	0	0	5	2	0
2-6315	injuring	state		month	How many ['injuring'] events happened in 08/2016 (month) in ('Washington',) (state) ?	4	4	4	0	0	2	4
2-6557	injuring	city		year	How many ['injuring'] events happened in 2016 (year) in ('New Jersey', 'Orange') (city) ?	4	0	0	0	4	2	0
2-6318	injuring	state		month	How many ['injuring'] events happened in 08/2015 (month) in ('Florida',) (state) ?	8	6	6	0	2	6	5
2-6559	injuring	city		year	How many ['injuring'] events happened in 2016 (year) in ('South Carolina', 'Columbia') (city) ?	3	1	1	0	2	2	1
2-6312	injuring	state		month	How many ['injuring'] events happened in 10/2016 (month) in ('New York',) (state) ?	12	2	2	0	10	5	1
2-6554	injuring	city		year	How many ['injuring'] events happened in 2016 (year) in ('Tennessee', 'Nashville') (city) ?	3	16	2	14	1	2	15
2-5464	killing		first	year	How many ['killing'] events happened in 2015 (year) that involve the name Jordan (first) ?	4	3	0	3	4	2	2
2-6311	injuring	state		month	How many ['injuring'] events happened in 05/2015 (month) in ('Louisiana',) (state) ?	3	3	3	0	0	2	3
2-6553	injuring	city		year	How many ['injuring'] events happened in 2016 (year) in ('Kansas', 'Wichita') (city) ?	4	2	0	2	4	3	2
2-6795	injuring		last	year	How many ['injuring'] events happened in 2016 (year) that involve the name Jones (last) ?	13	8	5	3	8	7	8
2-6556	injuring	city		year	How many ['injuring'] events happened in 2013 (year) in ('Rhode Island', 'Providence') (city) ?	4	0	0	0	4	2	0
2-6313	injuring	state		month	How many ['injuring'] events happened in 06/2016 (month) in ('Illinois',) (state) ?	15	9	6	3	9	11	9
2-6555	injuring	city		year	How many ['injuring'] events happened in 2015 (year) in ('Wisconsin', 'Milwaukee') (city) ?	3	2	2	0	1	2	2
2-6797	injuring		last	year	How many ['injuring'] events happened in 2013 (year) that involve the name Montgomery (last) ?	6	0	0	0	6	2	0
2-6780	injuring		last	year	How many ['injuring'] events happened in 2015 (year) that involve the name Howard (last) ?	9	0	0	0	9	2	0
2-6783	injuring		last	year	How many ['injuring'] events happened in 2016 (year) that involve the name Powell (last) ?	2	3	0	3	2	2	1
2-6540	injuring	city		year	How many ['injuring'] events happened in 2015 (year) in ('Alabama', 'Montgomery') (city) ?	2	0	0	0	2	2	0
2-5216	killing		last	month	How many ['killing'] events happened in 09/2016 (month) that involve the name Smith (last) ?	6	3	2	1	4	4	3
2-6305	injuring	state		month	How many ['injuring'] events happened in 11/2016 (month) in ('Wisconsin',) (state) ?	3	3	1	2	2	3	3
2-6547	injuring	city		year	How many ['injuring'] events happened in 2016 (year) in ('Texas', 'Dallas') (city) ?	17	10	8	2	9	6	9
2-5457	killing		first	year	How many ['killing'] events happened in 2016 (year) that involve the name John (first) ?	9	7	6	1	3	3	5
2-6304	injuring	state		month	How many ['injuring'] events happened in 02/2016 (month) in ('Texas',) (state) ?	8	8	7	1	1	3	8
2-6546	injuring	city		year	How many ['injuring'] events happened in 2014 (year) in ('Florida', 'Miami') (city) ?	5	6	5	1	0	3	6
2-6788	injuring		last	year	How many ['injuring'] events happened in 2016 (year) that involve the name Long (last) ?	3	0	0	0	3	2	0
2-6549	injuring	city		year	How many ['injuring'] events happened in 2015 (year) in ('New York', 'Buffalo') (city) ?	4	4	3	1	1	2	4
2-6306	injuring	state		month	How many ['injuring'] events happened in 06/2016 (month) in ('Georgia',) (state) ?	3	5	2	3	1	2	3
2-5696	killing		last	year	How many ['killing'] events happened in 2016 (year) that involve the name Hutton (last) ?	5	3	3	0	2	2	2
2-6543	injuring	city		year	How many ['injuring'] events happened in 2016 (year) in ('Texas', 'Spring') (city) ?	5	0	0	0	5	2	0
2-5453	killing		first	year	How many ['killing'] events happened in 2016 (year) that involve the name Anthony (first) ?	7	4	3	1	4	2	4
2-6542	injuring	city		year	How many ['injuring'] events happened in 2015 (year) in ('Ohio', 'Dayton') (city) ?	4	7	2	5	2	3	6
2-5456	killing		first	year	How many ['killing'] events happened in 2016 (year) that involve the name Leonard (first) ?	4	1	1	0	3	2	1
2-6545	injuring	city		year	How many ['injuring'] events happened in 2015 (year) in ('California', 'Sacramento') (city) ?	4	1	1	0	3	2	1
2-6302	injuring	state		month	How many ['injuring'] events happened in 12/2014 (month) in ('California',) (state) ?	2	1	1	0	1	2	1
2-6544	injuring	city		year	How many ['injuring'] events happened in 2016 (year) in ('Ohio', 'Cleveland') (city) ?	6	8	1	7	5	5	8
2-6528	injuring	city		year	How many ['injuring'] events happened in 2015 (year) in ('Tennessee', 'Nashville') (city) ?	4	7	3	4	1	4	6
2-6530	injuring	city		year	How many ['injuring'] events happened in 2016 (year) in ('Connecticut', 'Hartford') (city) ?	4	1	1	0	3	2	1
2-6771	injuring		last	year	How many ['injuring'] events happened in 2016 (year) that involve the name Brown (last) ?	26	12	6	6	20	9	11
2-6536	injuring	city		year	How many ['injuring'] events happened in 2016 (year) in ('California', 'Oakland') (city) ?	10	0	0	0	10	6	0
2-6535	injuring	city		year	How many ['injuring'] events happened in 2016 (year) in ('Alabama', 'Montgomery') (city) ?	3	1	0	1	3	3	1
2-5449	killing		first	year	How many ['killing'] events happened in 2016 (year) that involve the name Jamie (first) ?	4	3	2	1	2	2	2
2-6538	injuring	city		year	How many ['injuring'] events happened in 2015 (year) in ('California', 'Fresno') (city) ?	4	0	0	0	4	3	0
2-5201	killing		last	month	How many ['killing'] events happened in 06/2016 (month) that involve the name Jones (last) ?	8	1	1	0	7	2	1
2-5685	killing		last	year	How many ['killing'] events happened in 2016 (year) that involve the name Russell (last) ?	4	3	1	2	3	2	3
2-6531	injuring	city		year	How many ['injuring'] events happened in 2016 (year) in ('Florida', 'Orlando') (city) ?	7	0	0	0	7	5	0
2-5203	killing		last	month	How many ['killing'] events happened in 07/2015 (month) that involve the name Mitchell (last) ?	6	1	1	0	5	2	1
2-5687	killing		last	year	How many ['killing'] events happened in 2016 (year) that involve the name Green (last) ?	9	6	6	0	3	3	5
2-6534	injuring	city		year	How many ['injuring'] events happened in 2016 (year) in ('Texas', 'San Angelo') (city) ?	3	2	0	2	3	2	2
2-6518	injuring	city		year	How many ['injuring'] events happened in 2016 (year) in ('Indiana', 'Indianapolis') (city) ?	11	19	8	11	3	3	15
2-6517	injuring	city		year	How many ['injuring'] events happened in 2015 (year) in ('Ohio', 'Cleveland') (city) ?	4	1	0	1	4	2	1
2-6519	injuring	city		year	How many ['injuring'] events happened in 2015 (year) in ('New Jersey', 'Newark') (city) ?	4	1	1	0	3	3	1
2-5430	killing		first	year	How many ['killing'] events happened in 2015 (year) that involve the name Joseph (first) ?	5	4	4	0	1	2	2
2-6761	injuring		last	year	How many ['injuring'] events happened in 2016 (year) that involve the name Johnson (last) ?	9	5	1	4	8	4	5
2-5671	killing		last	year	How many ['killing'] events happened in 2016 (year) that involve the name Stewart (last) ?	9	1	1	0	8	3	1
2-5678	killing		last	year	How many ['killing'] events happened in 2015 (year) that involve the name Daniels (last) ?	2	1	1	0	1	2	1
2-6525	injuring	city		year	How many ['injuring'] events happened in 2016 (year) in ('South Carolina', 'Greenville') (city) ?	4	0	0	0	4	2	0
2-6524	injuring	city		year	How many ['injuring'] events happened in 2016 (year) in ('New Jersey', 'Trenton') (city) ?	3	2	2	0	1	2	2
2-6766	injuring		last	year	How many ['injuring'] events happened in 2016 (year) that involve the name Tillman (last) ?	4	1	1	0	3	2	1
2-6527	injuring	city		year	How many ['injuring'] events happened in 2016 (year) in ('Iowa', 'Des Moines') (city) ?	2	14	1	13	1	2	13
2-6769	injuring		last	year	How many ['injuring'] events happened in 2015 (year) that involve the name Edwards (last) ?	3	1	1	0	2	2	1
2-5437	killing		first	year	How many ['killing'] events happened in 2013 (year) that involve the name Demetrius (first) ?	3	1	1	0	2	2	1
2-5674	killing		last	year	How many ['killing'] events happened in 2013 (year) that involve the name Jackson (last) ?	4	1	0	1	4	2	1
2-6521	injuring	city		year	How many ['injuring'] events happened in 2016 (year) in ('Florida', 'Jacksonville') (city) ?	2	1	1	0	1	2	1
2-6520	injuring	city		year	How many ['injuring'] events happened in 2016 (year) in ('Virginia', 'Newport News') (city) ?	4	0	0	0	4	2	0
2-6523	injuring	city		year	How many ['injuring'] events happened in 2016 (year) in ('Alabama', 'Birmingham') (city) ?	2	0	0	0	2	2	0
2-6522	injuring	city		year	How many ['injuring'] events happened in 2015 (year) in ('Pennsylvania', 'Erie') (city) ?	6	0	0	0	6	2	0
2-6507	injuring	city		year	How many ['injuring'] events happened in 2016 (year) in ('Texas', 'San Antonio') (city) ?	13	16	12	4	1	6	11
2-6506	injuring	city		year	How many ['injuring'] events happened in 2016 (year) in ('Georgia', 'Atlanta') (city) ?	7	16	6	10	1	5	15
2-6748	injuring		last	year	How many ['injuring'] events happened in 2013 (year) that involve the name Turner (last) ?	2	1	1	0	1	2	1
2-6509	injuring	city		year	How many ['injuring'] events happened in 2016 (year) in ('New Jersey', 'Newark') (city) ?	2	1	1	0	1	2	1
2-6508	injuring	city		year	How many ['injuring'] events happened in 2014 (year) in ('California', 'Sacramento') (city) ?	4	2	2	0	2	4	2
2-6990	injuring		first	year	How many ['injuring'] events happened in 2016 (year) that involve the name Jeffery (first) ?	4	2	2	0	2	2	2
2-5660	killing		last	year	How many ['killing'] events happened in 2016 (year) that involve the name Dixon (last) ?	3	2	2	0	1	2	2
2-5667	killing		last	year	How many ['killing'] events happened in 2015 (year) that involve the name Clayton (last) ?	7	3	3	0	4	3	3
2-6514	injuring	city		year	How many ['injuring'] events happened in 2016 (year) in ('Indiana', 'Evansville') (city) ?	5	0	0	0	5	2	0
2-6998	injuring		first	year	How many ['injuring'] events happened in 2016 (year) that involve the name David (first) ?	6	5	1	4	5	3	5
2-5424	killing		first	year	How many ['killing'] events happened in 2016 (year) that involve the name Joseph (first) ?	3	2	0	2	3	2	1
2-6513	injuring	city		year	How many ['injuring'] events happened in 2016 (year) in ('Florida', 'Miami') (city) ?	13	17	11	6	2	5	16
2-6755	injuring		last	year	How many ['injuring'] events happened in 2016 (year) that involve the name Lee (last) ?	3	3	1	2	2	2	3
2-5427	killing		first	year	How many ['killing'] events happened in 2016 (year) that involve the name Jayden (first) ?	4	2	2	0	2	2	2
2-6516	injuring	city		year	How many ['injuring'] events happened in 2016 (year) in ('Virginia', 'Norfolk') (city) ?	3	5	3	2	0	3	5
2-6515	injuring	city		year	How many ['injuring'] events happened in 2016 (year) in ('Massachusetts', 'Boston') (city) ?	9	8	3	5	6	3	7
2-5663	killing		last	year	How many ['killing'] events happened in 2015 (year) that involve the name Anderson (last) ?	3	4	2	2	1	2	3
2-6510	injuring	city		year	How many ['injuring'] events happened in 2016 (year) in ('Kentucky', 'Lexington') (city) ?	4	5	4	1	0	4	5
2-6996	injuring		first	year	How many ['injuring'] events happened in 2015 (year) that involve the name Michael (first) ?	3	8	2	6	1	2	6
2-5422	killing		first	year	How many ['killing'] events happened in 2016 (year) that involve the name Shawn (first) ?	8	1	1	0	7	2	1
2-5649	killing		last	year	How many ['killing'] events happened in 2015 (year) that involve the name Johnson (last) ?	7	3	2	1	5	3	2
2-6738	injuring		last	year	How many ['injuring'] events happened in 2015 (year) that involve the name Wallace (last) ?	4	3	3	0	1	2	2
2-5648	killing		last	year	How many ['killing'] events happened in 2015 (year) that involve the name Edwards (last) ?	8	1	1	0	7	3	1
2-5409	killing		first	year	How many ['killing'] events happened in 2016 (year) that involve the name Gary (first) ?	5	1	1	0	4	3	1
2-6739	injuring		last	year	How many ['injuring'] events happened in 2015 (year) that involve the name Berry (last) ?	5	2	1	1	4	2	2
2-5892	killing	city	last		How many ['killing'] events happened in ('Indiana', 'Indianapolis') (city) that involve the name Johnson (last) ?	4	0	0	0	4	2	0
2-5891	killing	city	last		How many ['killing'] events happened in ('Illinois', 'Chicago') (city) that involve the name Bryant (last) ?	2	1	1	0	1	2	1
2-5414	killing		first	year	How many ['killing'] events happened in 2016 (year) that involve the name James (first) ?	11	4	2	2	9	6	4
2-5656	killing		last	year	How many ['killing'] events happened in 2015 (year) that involve the name Williams (last) ?	8	4	1	3	7	5	4
2-5898	killing	state	last		How many ['killing'] events happened in ('Louisiana',) (state) that involve the name Williams (last) ?	4	0	0	0	4	2	0
2-6502	injuring	city		year	How many ['injuring'] events happened in 2015 (year) in ('Indiana', 'Gary') (city) ?	4	0	0	0	4	2	0
2-6744	injuring		last	year	How many ['injuring'] events happened in 2016 (year) that involve the name Hines (last) ?	4	3	2	1	2	2	2
2-5899	killing	state	last		How many ['killing'] events happened in ('California',) (state) that involve the name Johnson (last) ?	6	0	0	0	6	2	0
2-5894	killing	state	last		How many ['killing'] events happened in ('Alabama',) (state) that involve the name Edwards (last) ?	2	0	0	0	2	2	0
2-6983	injuring		first	year	How many ['injuring'] events happened in 2016 (year) that involve the name James (first) ?	7	5	1	4	6	4	5
2-5896	killing	state	last		How many ['killing'] events happened in ('Illinois',) (state) that involve the name Jackson (last) ?	4	2	1	1	3	2	2
2-5895	killing	state	last		How many ['killing'] events happened in ('California',) (state) that involve the name Martinez (last) ?	5	2	2	0	3	2	1
2-6742	injuring		last	year	How many ['injuring'] events happened in 2016 (year) that involve the name Taylor (last) ?	3	1	0	1	3	2	1
2-6727	injuring		last	year	How many ['injuring'] events happened in 2015 (year) that involve the name Harris (last) ?	6	1	1	0	5	2	1
2-5637	killing		last	year	How many ['killing'] events happened in 2016 (year) that involve the name Coleman (last) ?	4	3	2	1	2	2	3
2-6726	injuring		last	year	How many ['injuring'] events happened in 2015 (year) that involve the name Smith (last) ?	10	8	2	6	8	5	6
2-6968	injuring		first	year	How many ['injuring'] events happened in 2013 (year) that involve the name Joshua (first) ?	3	0	0	0	3	2	0
2-5881	killing	state	first		How many ['killing'] events happened in ('Texas',) (state) that involve the name Willie (first) ?	3	3	3	0	0	2	2
2-4797	killing	state		year	How many ['killing'] events happened in 2016 (year) in ('Alaska',) (state) ?	5	5	5	0	0	2	4
2-5403	killing		first	year	How many ['killing'] events happened in 2016 (year) that involve the name Oliver (first) ?	4	1	1	0	3	2	1
2-5887	killing	city	last		How many ['killing'] events happened in ('Texas', 'San Antonio') (city) that involve the name Rodriguez (last) ?	4	4	4	0	0	2	2
2-4798	killing	state		year	How many ['killing'] events happened in 2016 (year) in ('Wisconsin',) (state) ?	16	21	11	10	5	10	19
2-6733	injuring		last	year	How many ['injuring'] events happened in 2016 (year) that involve the name Adams (last) ?	5	2	0	2	5	2	2
2-6978	injuring		first	year	How many ['injuring'] events happened in 2016 (year) that involve the name Brandon (first) ?	5	1	1	0	4	2	1
2-6735	injuring		last	year	How many ['injuring'] events happened in 2016 (year) that involve the name Young (last) ?	3	3	1	2	2	2	3
2-5883	killing	state	first		How many ['killing'] events happened in ('Texas',) (state) that involve the name Jonathan (first) ?	3	3	1	2	2	2	2
2-6730	injuring		last	year	How many ['injuring'] events happened in 2016 (year) that involve the name Carroll (last) ?	3	3	3	0	0	2	3
2-6971	injuring		first	year	How many ['injuring'] events happened in 2016 (year) that involve the name Adrian (first) ?	3	2	2	0	1	2	2
2-5401	killing		first	year	How many ['killing'] events happened in 2016 (year) that involve the name Timothy (first) ?	3	3	3	0	0	2	2
2-5885	killing	state	first		How many ['killing'] events happened in ('Texas',) (state) that involve the name Ryan (first) ?	5	5	4	1	1	2	3
2-6974	injuring		first	year	How many ['injuring'] events happened in 2016 (year) that involve the name Andrew (first) ?	3	5	2	3	1	2	4
2-4796	killing	state		year	How many ['killing'] events happened in 2015 (year) in ('New York',) (state) ?	24	0	0	0	24	10	0
2-5642	killing		last	year	How many ['killing'] events happened in 2016 (year) that involve the name Martinez (last) ?	6	5	4	1	2	3	3
2-5884	killing	state	first		How many ['killing'] events happened in ('California',) (state) that involve the name Luke (first) ?	4	2	2	0	2	2	1
2-6719	injuring		last	year	How many ['injuring'] events happened in 2013 (year) that involve the name Robinson (last) ?	5	2	2	0	3	2	1
2-5627	killing		last	year	How many ['killing'] events happened in 2015 (year) that involve the name Garcia (last) ?	4	1	1	0	3	2	1
2-5869	killing	state	first		How many ['killing'] events happened in ('New York',) (state) that involve the name John (first) ?	8	0	0	0	8	3	0
2-6958	injuring		first	year	How many ['injuring'] events happened in 2013 (year) that involve the name Angel (first) ?	4	2	2	0	2	2	2
2-5868	killing	state	first		How many ['killing'] events happened in ('Pennsylvania',) (state) that involve the name Kenneth (first) ?	5	3	3	0	2	2	2
2-6715	injuring		last	year	How many ['injuring'] events happened in 2016 (year) that involve the name Smith (last) ?	15	9	3	6	12	7	8
2-5629	killing		last	year	How many ['killing'] events happened in 2013 (year) that involve the name Wright (last) ?	3	0	0	0	3	2	0
2-6959	injuring		first	year	How many ['injuring'] events happened in 2016 (year) that involve the name Eric (first) ?	9	5	2	3	7	3	5
2-5870	killing	state	first		How many ['killing'] events happened in ('Texas',) (state) that involve the name William (first) ?	4	0	0	0	4	2	0
2-5876	killing	state	first		How many ['killing'] events happened in ('Michigan',) (state) that involve the name Demetrius (first) ?	3	0	0	0	3	2	0
2-5875	killing	state	first		How many ['killing'] events happened in ('California',) (state) that involve the name Kenneth (first) ?	3	1	1	0	2	2	1
2-5878	killing	state	first		How many ['killing'] events happened in ('Alabama',) (state) that involve the name Rodriquez (first) ?	3	2	2	0	1	2	2
2-5877	killing	state	first		How many ['killing'] events happened in ('Ohio',) (state) that involve the name James (first) ?	4	1	1	0	3	2	1
2-5872	killing	state	first		How many ['killing'] events happened in ('Tennessee',) (state) that involve the name Robert (first) ?	4	1	1	0	3	3	1
2-5871	killing	state	first		How many ['killing'] events happened in ('Florida',) (state) that involve the name Kevin (first) ?	4	1	1	0	3	2	1
2-5874	killing	state	first		How many ['killing'] events happened in ('Pennsylvania',) (state) that involve the name Donald (first) ?	9	1	1	0	8	2	1
2-6963	injuring		first	year	How many ['injuring'] events happened in 2015 (year) that involve the name Christopher (first) ?	5	2	0	2	5	3	2
2-5619	killing		last	year	How many ['killing'] events happened in 2016 (year) that involve the name Bellamy (last) ?	3	0	0	0	3	2	0
2-5615	killing		last	year	How many ['killing'] events happened in 2015 (year) that involve the name Stewart (last) ?	5	0	0	0	5	2	0
2-5857	killing		first	month	How many ['killing'] events happened in 12/2016 (month) that involve the name Christopher (first) ?	3	1	1	0	2	2	1
2-6706	injuring		last	year	How many ['injuring'] events happened in 2015 (year) that involve the name Sanders (last) ?	5	0	0	0	5	2	0
2-5865	killing	state	first		How many ['killing'] events happened in ('New Jersey',) (state) that involve the name Davon (first) ?	2	1	1	0	1	2	1
2-6954	injuring		first	year	How many ['injuring'] events happened in 2015 (year) that involve the name Joseph (first) ?	4	4	2	2	2	3	3
2-5867	killing	state	first		How many ['killing'] events happened in ('Illinois',) (state) that involve the name Anthony (first) ?	7	2	2	0	5	2	2
2-6952	injuring		first	year	How many ['injuring'] events happened in 2016 (year) that involve the name Reginald (first) ?	4	3	3	0	1	2	1
2-5862	killing	city	first		How many ['killing'] events happened in ('Illinois', 'Chicago') (city) that involve the name Elijah (first) ?	5	0	0	0	5	3	0
2-5605	killing		last	year	How many ['killing'] events happened in 2016 (year) that involve the name Smith (last) ?	14	9	6	3	8	8	8
2-6935	injuring		first	year	How many ['injuring'] events happened in 2015 (year) that involve the name Anthony (first) ?	6	0	0	0	6	3	0
2-5607	killing		last	year	How many ['killing'] events happened in 2016 (year) that involve the name Jones (last) ?	13	8	6	2	7	6	7
2-5849	killing		first	month	How many ['killing'] events happened in 09/2016 (month) that involve the name Christopher (first) ?	4	0	0	0	4	2	0
2-6937	injuring		first	year	How many ['injuring'] events happened in 2015 (year) that involve the name Thomas (first) ?	5	2	0	2	5	2	1
2-5854	killing		first	month	How many ['killing'] events happened in 12/2015 (month) that involve the name Michael (first) ?	3	3	1	2	2	2	3
2-6701	injuring		last	year	How many ['injuring'] events happened in 2016 (year) that involve the name Thomas (last) ?	3	6	2	4	1	3	6
2-6945	injuring		first	year	How many ['injuring'] events happened in 2016 (year) that involve the name Jacob (first) ?	10	2	1	1	9	3	2
2-5852	killing		first	month	How many ['killing'] events happened in 08/2016 (month) that involve the name Brandon (first) ?	3	0	0	0	3	2	0
2-5839	killing		first	month	How many ['killing'] events happened in 10/2016 (month) that involve the name William (first) ?	5	2	2	0	3	2	2
2-5835	killing		first	month	How many ['killing'] events happened in 08/2016 (month) that involve the name Thomas (first) ?	8	2	2	0	6	3	2
2-5837	killing		first	month	How many ['killing'] events happened in 12/2016 (month) that involve the name Michael (first) ?	3	3	2	1	1	2	2
2-6926	injuring		first	year	How many ['injuring'] events happened in 2016 (year) that involve the name Christopher (first) ?	7	13	3	10	4	4	11
2-5842	killing		first	month	How many ['killing'] events happened in 11/2016 (month) that involve the name Jacob (first) ?	3	2	2	0	1	2	2
2-6933	injuring		first	year	How many ['injuring'] events happened in 2016 (year) that involve the name Antonio (first) ?	5	2	2	0	3	2	1
2-5828	killing		first	month	How many ['killing'] events happened in 11/2016 (month) that involve the name Richard (first) ?	4	1	1	0	3	2	1
2-4977	killing	city		year	How many ['killing'] events happened in 2016 (year) in ('Louisiana', 'Shreveport') (city) ?	3	7	3	4	0	3	6
2-5825	killing		first	month	How many ['killing'] events happened in 09/2016 (month) that involve the name Joshua (first) ?	4	1	1	0	3	2	1
2-5824	killing		first	month	How many ['killing'] events happened in 11/2016 (month) that involve the name Marcus (first) ?	5	0	0	0	5	2	0
2-4979	killing	city		year	How many ['killing'] events happened in 2016 (year) in ('Louisiana', 'Baton Rouge') (city) ?	6	3	2	1	4	5	2
2-6916	injuring		first	year	How many ['injuring'] events happened in 2016 (year) that involve the name William (first) ?	2	4	1	3	1	2	3
2-4984	killing	city		year	How many ['killing'] events happened in 2016 (year) in ('Florida', 'Miami Gardens') (city) ?	3	2	2	0	1	2	2
2-4981	killing	city		year	How many ['killing'] events happened in 2014 (year) in ('Georgia', 'Atlanta') (city) ?	4	3	2	1	2	2	2
2-4983	killing	city		year	How many ['killing'] events happened in 2016 (year) in ('California', 'Long Beach') (city) ?	3	0	0	0	3	2	0
2-6907	injuring		first	year	How many ['injuring'] events happened in 2013 (year) that involve the name Demetrius (first) ?	6	1	1	0	5	3	1
2-5814	killing		last	year	How many ['killing'] events happened in 2013 (year) that involve the name Young (last) ?	5	2	2	0	3	2	1
2-4967	killing	city		year	How many ['killing'] events happened in 2016 (year) in ('Georgia', 'Norcross') (city) ?	2	0	0	0	2	2	0
2-4968	killing	city		year	How many ['killing'] events happened in 2016 (year) in ('Texas', 'San Antonio') (city) ?	8	9	8	1	0	4	6
2-5816	killing		last	year	How many ['killing'] events happened in 2016 (year) that involve the name Reid (last) ?	4	1	1	0	3	2	1
2-4969	killing	city		year	How many ['killing'] events happened in 2015 (year) in ('Louisiana', 'Baton Rouge') (city) ?	5	3	3	0	2	3	3
2-4973	killing	city		year	How many ['killing'] events happened in 2016 (year) in ('Arizona', 'Phoenix') (city) ?	3	5	3	2	0	3	5
2-5821	killing		first	month	How many ['killing'] events happened in 10/2016 (month) that involve the name Christopher (first) ?	3	4	3	1	0	2	3
2-4975	killing	city		year	How many ['killing'] events happened in 2016 (year) in ('Florida', 'Orlando') (city) ?	3	0	0	0	3	2	0
2-6911	injuring		first	year	How many ['injuring'] events happened in 2016 (year) that involve the name Edward (first) ?	3	0	0	0	3	2	0
2-5807	killing		last	year	How many ['killing'] events happened in 2013 (year) that involve the name Smith (last) ?	3	2	2	0	1	2	2
2-4955	killing	city		year	How many ['killing'] events happened in 2016 (year) in ('Missouri', 'Saint Louis') (city) ?	5	7	5	2	0	3	7
2-4957	killing	city		year	How many ['killing'] events happened in 2016 (year) in ('Ohio', 'Columbus') (city) ?	9	3	3	0	6	3	2
2-5804	killing		last	year	How many ['killing'] events happened in 2016 (year) that involve the name Sims (last) ?	5	4	2	2	3	2	3
2-4964	killing	city		year	How many ['killing'] events happened in 2015 (year) in ('Indiana', 'Indianapolis') (city) ?	8	2	2	0	6	4	2
2-4965	killing	city		year	How many ['killing'] events happened in 2016 (year) in ('Ohio', 'Cincinnati') (city) ?	3	2	1	1	2	2	2
2-5811	killing		last	year	How many ['killing'] events happened in 2016 (year) that involve the name Wallace (last) ?	5	3	3	0	2	2	2
2-6900	injuring		first	year	How many ['injuring'] events happened in 2016 (year) that involve the name Elijah (first) ?	8	7	3	4	5	4	5
2-4948	killing	city		year	How many ['killing'] events happened in 2016 (year) in ('Florida', 'Miami') (city) ?	9	13	8	5	1	4	12
2-4949	killing	city		year	How many ['killing'] events happened in 2016 (year) in ('Texas', 'Houston') (city) ?	31	24	20	4	11	13	23
2-4945	killing	city		year	How many ['killing'] events happened in 2016 (year) in ('Indiana', 'Indianapolis') (city) ?	21	14	11	3	10	8	12
2-4946	killing	city		year	How many ['killing'] events happened in 2015 (year) in ('Ohio', 'Dayton') (city) ?	4	3	2	1	2	2	3
2-4952	killing	city		year	How many ['killing'] events happened in 2014 (year) in ('Florida', 'Miami') (city) ?	6	6	6	0	0	4	6
2-4953	killing	city		year	How many ['killing'] events happened in 2015 (year) in ('Arkansas', 'Little Rock') (city) ?	5	7	2	5	3	2	7
2-4938	killing	city		year	How many ['killing'] events happened in 2015 (year) in ('Arizona', 'Tucson') (city) ?	2	4	1	3	1	2	3
2-4933	killing	city		year	How many ['killing'] events happened in 2015 (year) in ('Oklahoma', 'Tulsa') (city) ?	2	1	1	0	1	2	1
2-4934	killing	city		year	How many ['killing'] events happened in 2013 (year) in ('Texas', 'Houston') (city) ?	5	10	5	5	0	2	8
2-4942	killing	city		year	How many ['killing'] events happened in 2016 (year) in ('Maryland', 'Baltimore') (city) ?	6	6	4	2	2	3	6
2-4928	killing	city		year	How many ['killing'] events happened in 2015 (year) in ('Texas', 'Houston') (city) ?	9	9	6	3	3	5	9
2-4925	killing	city		year	How many ['killing'] events happened in 2015 (year) in ('California', 'Stockton') (city) ?	4	0	0	0	4	3	0
2-4930	killing	city		year	How many ['killing'] events happened in 2016 (year) in ('Wisconsin', 'Milwaukee') (city) ?	12	8	8	0	4	7	7
2-4932	killing	city		year	How many ['killing'] events happened in 2015 (year) in ('Florida', 'Miami') (city) ?	5	6	4	2	1	3	6
2-4916	killing	city		year	How many ['killing'] events happened in 2015 (year) in ('Texas', 'San Antonio') (city) ?	7	2	2	0	5	2	2
2-4918	killing	city		year	How many ['killing'] events happened in 2016 (year) in ('California', 'Stockton') (city) ?	4	0	0	0	4	3	0
2-4911	killing	city		year	How many ['killing'] events happened in 2016 (year) in ('Illinois', 'Chicago (Englewood)') (city) ?	10	11	2	9	8	4	10
2-4914	killing	city		year	How many ['killing'] events happened in 2015 (year) in ('Ohio', 'Cleveland') (city) ?	7	1	0	1	7	3	1
2-4919	killing	city		year	How many ['killing'] events happened in 2015 (year) in ('Maryland', 'Baltimore') (city) ?	5	5	2	3	3	5	5
2-7198	job_firing	state		year	How many ['job_firing'] events happened in 2015 (year) in (None,) (state) ?	2	0	0	0	2	2	0
2-7195	job_firing	city		year	How many ['job_firing'] events happened in 2014 (year) in (None, 'London') (city) ?	5	0	0	0	5	2	0
2-4921	killing	city		year	How many ['killing'] events happened in 2016 (year) in ('Missouri', 'Kansas City') (city) ?	10	5	5	0	5	5	5
2-4907	killing	city		year	How many ['killing'] events happened in 2016 (year) in ('Mississippi', 'Vicksburg') (city) ?	4	1	1	0	3	2	1
2-4902	killing	city		year	How many ['killing'] events happened in 2013 (year) in ('California', 'Vallejo') (city) ?	6	2	2	0	4	3	1
2-4903	killing	city		year	How many ['killing'] events happened in 2016 (year) in ('California', 'Sacramento') (city) ?	9	4	4	0	5	5	4
2-7182	fire_burning	city		year	How many ['fire_burning'] events happened in 2006 (year) in ('California', 'Los Angeles') (city) ?	48	43	42	1	6	48	41
2-7180	fire_burning	city		year	How many ['fire_burning'] events happened in 2007 (year) in ('Nevada', 'Las Vegas') (city) ?	4	1	1	0	3	4	1
2-4909	killing	city		year	How many ['killing'] events happened in 2016 (year) in ('Alabama', 'Montgomery') (city) ?	2	0	0	0	2	2	0
2-7187	fire_burning	state		day	How many ['fire_burning'] events happened in 12/08/2006 (day) in ('California',) (state) ?	2	2	2	0	0	2	2
2-6095	injuring	city		month	How many ['injuring'] events happened in 11/2016 (month) in ('Ohio', 'Columbus') (city) ?	3	1	1	0	2	2	1
2-7185	fire_burning	state		day	How many ['fire_burning'] events happened in 09/09/2008 (day) in ('Oregon',) (state) ?	2	0	0	0	2	2	0
2-7186	fire_burning	state		day	How many ['fire_burning'] events happened in 23/01/2006 (day) in ('California',) (state) ?	2	1	1	0	1	2	1
2-6097	injuring	city		month	How many ['injuring'] events happened in 09/2016 (month) in ('Texas', 'Houston') (city) ?	9	7	6	1	3	2	7
2-7183	fire_burning	state		day	How many ['fire_burning'] events happened in 03/10/2006 (day) in ('California',) (state) ?	2	2	2	0	0	2	2
