3-110220	injuring	city	last		How many people were injured in ('Illinois', 'Chicago (Englewood)') (city) that involve the name Agnew (last) ?	2	2	2	0	0	0	4
3-90024	killing	city	full_name		How many people were killed in ('California', 'San Diego') (city) that involve the name Hank Mata (full_name) ?	2	2	2	0	0	1	3
3-94866	injuring	city		year	How many people were injured in 2016 (year) in ('Texas', 'Dallas') (city) ?	17	10	8	2	9	13	5
3-94865	injuring	city		year	How many people were injured in 2016 (year) in ('Arkansas', 'Little Rock') (city) ?	4	3	1	2	3	4	10
3-93532	injuring	state		day	How many people were injured in 14/05/2016 (day) in ('District of Columbia',) (state) ?	1	0	0	0	1	1	0
3-95712	injuring	city		month	How many people were injured in 08/2015 (month) in ('Georgia', 'Savannah') (city) ?	1	0	0	0	1	1	0
3-94867	injuring	city		year	How many people were injured in 2015 (year) in ('South Carolina', 'Conway') (city) ?	1	0	0	0	1	1	0
3-82882	killing		last	day	How many people were killed in 28/06/2016 (day) that involve the name Dolan (last) ?	3	2	2	0	1	2	3
3-103928	injuring		last	year	How many people were injured in 2016 (year) that involve the name Woods (last) ?	7	5	3	2	4	0	10
3-101752	injuring		last	month	How many people were injured in 09/2014 (month) that involve the name McElroy (last) ?	1	0	0	0	1	0	0
3-102601	injuring		full_name	month	How many people were injured in 11/2016 (month) that involve the name Sang Kim (full_name) ?	2	1	1	0	1	0	0
3-93542	injuring	state		day	How many people were injured in 15/10/2016 (day) in ('Illinois',) (state) ?	2	2	0	2	2	5	18
3-94871	injuring	city		year	How many people were injured in 2016 (year) in ('Louisiana', 'Baton Rouge') (city) ?	8	8	5	3	3	9	19
3-92677	killing	state	last		How many people were killed in ('Texas',) (state) that involve the name Martinez (last) ?	4	8	4	4	0	1	6
3-94858	injuring	city		year	How many people were injured in 2013 (year) in ('Missouri', 'Kansas City') (city) ?	2	3	2	1	0	3	9
3-93526	injuring	state		day	How many people were injured in 29/04/2016 (day) in ('Georgia',) (state) ?	2	1	1	0	1	2	1
3-94856	injuring	city		year	How many people were injured in 2015 (year) in ('Nebraska', 'Omaha') (city) ?	2	0	0	0	2	7	0
3-103919	injuring		last	year	How many people were injured in 2015 (year) that involve the name Clayton (last) ?	5	5	3	2	2	1	11
3-103912	injuring		last	year	How many people were injured in 2015 (year) that involve the name Howard (last) ?	9	3	3	0	6	0	4
3-85916	killing		first	year	How many people were killed in 2016 (year) that involve the name Maurice (first) ?	6	6	4	2	2	0	0
3-100413	injuring		first	year	How many people were injured in 2016 (year) that involve the name Vincent (first) ?	3	4	2	2	1	0	1
3-100897	injuring		first	month	How many people were injured in 08/2015 (month) that involve the name Sammuel (first) ?	1	0	0	0	1	0	0
3-100890	injuring		first	month	How many people were injured in 09/2016 (month) that involve the name Dominique (first) ?	4	1	1	0	3	0	0
3-81553	killing		full_name	year	How many people were killed in 2016 (year) that involve the name Reynaldo Pizana (full_name) ?	1	1	1	0	0	1	2
3-100891	injuring		first	month	How many people were injured in 02/2015 (month) that involve the name Pamela (first) ?	2	0	0	0	2	1	0
3-89013	killing	city	last		How many people were killed in ('New York', 'Rome') (city) that involve the name Bartle (last) ?	1	0	0	0	1	0	0
3-107072	injuring	city	first		How many people were injured in ('North Carolina', 'Statesville') (city) that involve the name Christopher (first) ?	1	1	1	0	0	1	0
3-94842	injuring	city		year	How many people were injured in 2016 (year) in ('New Jersey', 'Trenton') (city) ?	3	2	2	0	1	11	4
3-92664	killing	state	last		How many people were killed in ('California',) (state) that involve the name Colbert (last) ?	2	1	1	0	1	0	0
3-90489	killing	state	full_name		How many people were killed in ('Kentucky',) (state) that involve the name Ashley Wright (full_name) ?	1	1	1	0	0	0	2
3-94847	injuring	city		year	How many people were injured in 2015 (year) in ('Arizona', 'Flagstaff') (city) ?	2	0	0	0	2	3	0
3-94846	injuring	city		year	How many people were injured in 2016 (year) in ('California', 'Stockton') (city) ?	1	0	0	0	1	3	0
3-93514	injuring	state		day	How many people were injured in 04/07/2015 (day) in ('Texas',) (state) ?	1	0	0	0	1	4	0
3-100437	injuring		first	year	How many people were injured in 2013 (year) that involve the name John (first) ?	4	21	4	17	0	2	55
3-102614	injuring		full_name	month	How many people were injured in 10/2016 (month) that involve the name Kristian Piazza (full_name) ?	1	1	1	0	0	0	2
3-89016	killing	city	last		How many people were killed in ('Texas', 'San Antonio') (city) that involve the name Rodriguez (last) ?	4	4	4	0	0	1	1
3-100438	injuring		first	year	How many people were injured in 2013 (year) that involve the name Joshua (first) ?	3	3	2	1	1	0	5
3-76188	killing	state		month	How many people were killed in 01/2016 (month) in ('Georgia',) (state) ?	3	2	2	0	1	3	0
3-83702	killing		full_name	month	How many people were killed in 03/2014 (month) that involve the name Braison Howard (full_name) ?	2	1	1	0	1	1	0
3-82858	killing		last	day	How many people were killed in 27/05/2016 (day) that involve the name Casullo (last) ?	2	1	1	0	1	3	0
3-76180	killing	state		month	How many people were killed in 06/2016 (month) in ('Ohio',) (state) ?	3	2	2	0	1	3	1
3-107079	injuring	city	first		How many people were injured in ('California', 'Long Beach') (city) that involve the name Jerry (first) ?	1	0	0	0	1	0	0
3-94833	injuring	city		year	How many people were injured in 2015 (year) in ('California', 'Fresno') (city) ?	4	0	0	0	4	7	0
3-111566	job_firing		first	month	How many people were fired in 01/2015 (month) that involve the name William (first) ?	3	0	0	0	3	1	0
3-92657	killing	state	last		How many people were killed in ('Arizona',) (state) that involve the name Ramirez (last) ?	1	0	0	0	1	1	0
3-94834	injuring	city		year	How many people were injured in 2016 (year) in ('Massachusetts', 'Boston') (city) ?	9	8	3	5	6	8	19
3-93509	injuring	state		day	How many people were injured in 29/08/2016 (day) in ('New Jersey',) (state) ?	4	1	1	0	3	5	1
3-93508	injuring	state		day	How many people were injured in 16/06/2013 (day) in ('Illinois',) (state) ?	2	0	0	0	2	3	0
3-80203	killing		first	day	How many people were killed in 02/12/2016 (day) that involve the name Christopher (first) ?	2	1	1	0	1	1	0
3-100433	injuring		first	year	How many people were injured in 2016 (year) that involve the name Jeffery (first) ?	4	3	3	0	1	0	5
3-101766	injuring		last	month	How many people were injured in 09/2016 (month) that involve the name Patton (last) ?	5	1	1	0	4	0	5
3-80685	killing		first	day	How many people were killed in 16/01/2016 (day) that involve the name Ahmad (first) ?	2	2	2	0	0	0	0
3-99291	injuring	city		day	How many people were injured in 27/09/2015 (day) in ('Missouri', 'Kansas City') (city) ?	1	1	1	0	0	4	0
3-99294	injuring	city		day	How many people were injured in 11/01/2016 (day) in ('Florida', 'Jacksonville') (city) ?	1	0	0	0	1	1	0
3-76192	killing	state		month	How many people were killed in 10/2016 (month) in ('South Carolina',) (state) ?	2	1	1	0	1	5	0
3-77041	killing	state		day	How many people were killed in 27/05/2015 (day) in ('California',) (state) ?	1	1	1	0	0	2	0
3-77042	killing	state		day	How many people were killed in 01/10/2016 (day) in ('South Carolina',) (state) ?	1	1	1	0	0	4	0
3-93993	injuring	state		day	How many people were injured in 22/12/2015 (day) in ('Kansas',) (state) ?	1	1	1	0	0	1	0
3-94840	injuring	city		year	How many people were injured in 2014 (year) in ('Tennessee', 'Clarksville') (city) ?	1	0	0	0	1	4	0
3-93991	injuring	state		day	How many people were injured in 14/10/2016 (day) in ('Illinois',) (state) ?	3	0	0	0	3	7	0
3-88143	killing	state	first		How many people were killed in ('Texas',) (state) that involve the name Steven (first) ?	3	2	2	0	1	1	0
3-93974	injuring	state		day	How many people were injured in 04/05/2016 (day) in ('Minnesota',) (state) ?	2	1	1	0	1	7	7
3-108349	injuring	state	last		How many people were injured in ('Louisiana',) (state) that involve the name Williams (last) ?	4	2	2	0	2	0	0
3-101707	injuring		last	month	How many people were injured in 06/2016 (month) that involve the name Collins (last) ?	2	2	2	0	0	1	1
3-100861	injuring		first	year	How many people were injured in 2016 (year) that involve the name Ariana (first) ?	2	2	1	1	1	1	18
3-81502	killing		full_name	year	How many people were killed in 2016 (year) that involve the name Nathaniel Lowe (full_name) ?	1	1	1	0	0	0	0
3-99284	injuring	city		day	How many people were injured in 14/07/2016 (day) in ('Michigan', 'Eastpointe') (city) ?	3	2	2	0	1	2	2
3-107010	injuring	city	first		How many people were injured in ('Ohio', 'Youngstown') (city) that involve the name Dionte (first) ?	1	1	1	0	0	0	0
3-76164	killing	state		month	How many people were killed in 09/2016 (month) in ('Iowa',) (state) ?	4	3	3	0	1	2	1
3-79674	killing		first	month	How many people were killed in 06/2015 (month) that involve the name Bobby (first) ?	2	1	1	0	1	1	2
3-108333	injuring	state	last		How many people were injured in ('Pennsylvania',) (state) that involve the name Barnes (last) ?	2	2	2	0	0	0	3
3-94814	injuring	city		year	How many people were injured in 2016 (year) in ('New Jersey', 'Newark') (city) ?	2	1	1	0	1	6	0
3-94813	injuring	city		year	How many people were injured in 2015 (year) in ('Florida', 'Miami Gardens') (city) ?	3	3	3	0	0	7	7
3-94812	injuring	city		year	How many people were injured in 2014 (year) in ('California', 'San Francisco') (city) ?	4	4	4	0	0	17	18
3-100848	injuring		first	year	How many people were injured in 2016 (year) that involve the name Grandson (first) ?	1	1	1	0	0	0	1
3-100846	injuring		first	year	How many people were injured in 2013 (year) that involve the name Brandon (first) ?	4	3	3	0	1	1	6
3-99274	injuring	city		day	How many people were injured in 06/05/2016 (day) in ('Maryland', 'Bethesda') (city) ?	1	0	0	0	1	3	0
3-100853	injuring		first	year	How many people were injured in 2015 (year) that involve the name Jayson (first) ?	1	1	1	0	0	0	0
3-79209	killing		first	month	How many people were killed in 12/2016 (month) that involve the name Michael (first) ?	3	6	3	3	0	1	6
3-106159	injuring		last	day	How many people were injured in 09/10/2015 (day) that involve the name Jones (last) ?	2	2	2	0	0	0	3
3-79680	killing		first	month	How many people were killed in 10/2014 (month) that involve the name Mary (first) ?	2	1	1	0	1	1	2
3-79683	killing		first	month	How many people were killed in 09/2016 (month) that involve the name Lauren (first) ?	1	1	1	0	0	1	3
3-93971	injuring	state		day	How many people were injured in 25/12/2016 (day) in ('Arizona',) (state) ?	2	0	0	0	2	2	0
3-93970	injuring	state		day	How many people were injured in 31/12/2013 (day) in ('New York',) (state) ?	2	0	0	0	2	6	0
3-99277	injuring	city		day	How many people were injured in 28/10/2016 (day) in ('Florida', 'Miami Gardens') (city) ?	1	0	0	0	1	4	0
3-107480	injuring	city	first		How many people were injured in ('Tennessee', 'Nashville') (city) that involve the name Cameron (first) ?	1	1	1	0	0	0	3
3-88121	killing	state	first		How many people were killed in ('Tennessee',) (state) that involve the name Kaemon (first) ?	1	1	1	0	0	0	0
3-93952	injuring	state		day	How many people were injured in 31/07/2015 (day) in ('Iowa',) (state) ?	1	0	0	0	1	1	0
3-90443	killing	state	full_name		How many people were killed in ('California',) (state) that involve the name Maige Lee (full_name) ?	2	0	0	0	2	1	0
3-94804	injuring	city		year	How many people were injured in 2014 (year) in ('Washington', 'Seattle') (city) ?	1	0	0	0	1	4	0
3-111533	job_firing		last	year	How many people were fired in 2011 (year) that involve the name Acerra (last) ?	3	0	0	0	3	1	0
3-111531	job_firing		last	year	How many people were fired in 2015 (year) that involve the name Cole (last) ?	1	0	0	0	1	1	0
3-94801	injuring	city		year	How many people were injured in 2013 (year) in ('Delaware', 'Wilmington') (city) ?	3	0	0	0	3	8	0
3-94808	injuring	city		year	How many people were injured in 2013 (year) in ('Kansas', 'Wichita') (city) ?	4	2	2	0	2	10	11
3-94806	injuring	city		year	How many people were injured in 2016 (year) in ('Ohio', 'Dayton') (city) ?	4	2	2	0	2	4	0
3-81964	killing		last	year	How many people were killed in 2016 (year) that involve the name Adams (last) ?	7	12	2	10	5	1	12
3-77476	killing	city		month	How many people were killed in 08/2016 (month) in ('Missouri', 'Kansas City') (city) ?	3	1	1	0	2	2	2
3-100401	injuring		first	year	How many people were injured in 2015 (year) that involve the name Anthony (first) ?	6	9	3	6	3	0	0
3-111527	job_firing		last	year	How many people were fired in 2012 (year) that involve the name Smith (last) ?	2	0	0	0	2	1	0
3-107037	injuring	city	first		How many people were injured in ('Illinois', 'Chicago') (city) that involve the name Steve (first) ?	3	0	0	0	3	1	0
3-76140	killing	state		month	How many people were killed in 06/2016 (month) in ('Massachusetts',) (state) ?	7	5	5	0	2	2	5
3-106186	injuring		last	day	How many people were injured in 26/06/2016 (day) that involve the name Wingfield (last) ?	2	0	0	0	2	0	0
3-77472	killing	city		month	How many people were killed in 06/2015 (month) in ('Florida', 'Greenacres') (city) ?	2	0	0	0	2	4	0
3-82817	killing		last	year	How many people were killed in 2016 (year) that involve the name Clark (last) ?	2	3	2	1	0	2	3
3-99268	injuring	city		day	How many people were injured in 31/07/2015 (day) in ('Tennessee', 'Nashville') (city) ?	1	0	0	0	1	1	0
3-110671	injuring	state	full_name		How many people were injured in ('Kentucky',) (state) that involve the name Deandre Strewsberry (full_name) ?	4	3	3	0	1	1	6
3-93942	injuring	state		day	How many people were injured in 19/06/2016 (day) in ('Missouri',) (state) ?	1	1	1	0	0	1	0
3-110670	injuring	state	full_name		How many people were injured in ('Illinois',) (state) that involve the name Charles Groom (full_name) ?	2	0	0	0	2	0	0
3-109203	injuring	city	full_name		How many people were injured in ('Connecticut', 'Bridgeport') (city) that involve the name Jacob Marrero (full_name) ?	6	0	0	0	6	1	0
3-93945	injuring	state		day	How many people were injured in 05/11/2016 (day) in ('Texas',) (state) ?	4	4	3	1	1	5	4
3-109204	injuring	city	full_name		How many people were injured in ('Georgia', 'Savannah') (city) that involve the name Christasia Lawrence (full_name) ?	1	0	0	0	1	0	0
3-101716	injuring		last	month	How many people were injured in 10/2016 (month) that involve the name Patayo (last) ?	1	1	1	0	0	1	0
3-101712	injuring		last	month	How many people were injured in 08/2015 (month) that involve the name Deemer (last) ?	2	0	0	0	2	1	0
3-81978	killing		last	year	How many people were killed in 2016 (year) that involve the name Reid (last) ?	4	2	2	0	2	1	5
3-82825	killing		last	year	How many people were killed in 2016 (year) that involve the name Crawford (last) ?	1	2	1	1	0	1	3
3-99253	injuring	city		day	How many people were injured in 10/08/2016 (day) in ('Illinois', 'Evanston') (city) ?	1	0	0	0	1	4	0
3-77006	killing	state		day	How many people were killed in 17/11/2015 (day) in ('Arkansas',) (state) ?	2	3	2	1	0	1	1
3-99255	injuring	city		day	How many people were injured in 17/01/2016 (day) in ('Georgia', 'Maysville') (city) ?	1	0	0	0	1	1	0
3-79662	killing		first	month	How many people were killed in 12/2014 (month) that involve the name Lety (first) ?	1	0	0	0	1	0	0
3-99257	injuring	city		day	How many people were injured in 27/07/2016 (day) in ('Florida', 'Gainesville') (city) ?	2	2	2	0	0	2	1
3-103536	injuring		last	year	How many people were injured in 2016 (year) that involve the name Tillman (last) ?	4	3	3	0	1	1	1
3-98394	injuring	state		month	How many people were injured in 08/2015 (month) in ('Florida',) (state) ?	8	6	6	0	2	13	7
3-99240	injuring	city		day	How many people were injured in 02/06/2013 (day) in ('Virginia', 'Virginia Beach') (city) ?	1	1	1	0	0	7	4
3-98396	injuring	state		month	How many people were injured in 08/2016 (month) in ('Pennsylvania',) (state) ?	9	14	8	6	1	9	7
3-98395	injuring	state		month	How many people were injured in 07/2016 (month) in ('Ohio',) (state) ?	6	7	4	3	2	7	6
3-76126	killing	state		month	How many people were killed in 01/2016 (month) in ('Alabama',) (state) ?	2	0	0	0	2	1	0
3-79636	killing		first	month	How many people were killed in 07/2015 (month) that involve the name Charlie (first) ?	2	1	1	0	1	1	0
3-100023	injuring		first	year	How many people were injured in 2016 (year) that involve the name Ketrell (first) ?	1	0	0	0	1	0	0
3-76128	killing	state		month	How many people were killed in 10/2016 (month) in ('Michigan',) (state) ?	3	1	0	1	3	2	4
3-101354	injuring		first	month	How many people were injured in 09/2016 (month) that involve the name Joseph (first) ?	1	1	1	0	0	0	0
3-103531	injuring		last	year	How many people were injured in 2015 (year) that involve the name Edwards (last) ?	3	2	2	0	1	0	6
3-76129	killing	state		month	How many people were killed in 08/2016 (month) in ('Pennsylvania',) (state) ?	6	7	6	1	0	3	9
3-75278	killing	city		day	How many people were killed in 09/07/2013 (day) in ('Illinois', 'Rockford') (city) ?	2	0	0	0	2	2	0
3-98398	injuring	state		month	How many people were injured in 08/2013 (month) in ('Delaware',) (state) ?	1	3	0	3	1	4	5
3-99245	injuring	city		day	How many people were injured in 13/07/2013 (day) in ('District of Columbia', 'Washington') (city) ?	2	0	0	0	2	4	0
3-111147	injuring	state	full_name		How many people were injured in ('Arkansas',) (state) that involve the name Sirtravis Franklin (full_name) ?	2	2	2	0	0	0	0
3-93928	injuring	state		day	How many people were injured in 24/12/2016 (day) in ('New York',) (state) ?	1	0	0	0	1	1	0
3-93927	injuring	state		day	How many people were injured in 20/02/2015 (day) in ('California',) (state) ?	2	1	1	0	1	4	3
3-89448	killing	city	last		How many people were killed in ('Illinois', 'Chicago') (city) that involve the name Davis (last) ?	2	0	0	0	2	1	0
3-103519	injuring		last	year	How many people were injured in 2015 (year) that involve the name Kennedy (last) ?	3	6	2	4	1	2	18
3-111140	injuring	state	full_name		How many people were injured in ('Wisconsin',) (state) that involve the name Deonte Thomas (full_name) ?	1	1	1	0	0	0	0
3-88597	killing	state	first		How many people were killed in ('Ohio',) (state) that involve the name Timothy (first) ?	3	0	0	0	3	2	0
3-77464	killing	city		month	How many people were killed in 04/2016 (month) in ('Wisconsin', 'Wisconsin Rapids') (city) ?	2	2	2	0	0	3	1
3-79643	killing		first	month	How many people were killed in 11/2015 (month) that involve the name Johnathan (first) ?	1	1	1	0	0	1	2
3-81953	killing		last	year	How many people were killed in 2015 (year) that involve the name Daniels (last) ?	2	1	1	0	1	1	2
3-103524	injuring		last	year	How many people were injured in 2016 (year) that involve the name Harris (last) ?	6	11	4	7	2	0	17
3-104855	injuring		full_name	year	How many people were injured in 2014 (year) that involve the name Darnae Christon (full_name) ?	2	1	1	0	1	0	0
3-77467	killing	city		month	How many people were killed in 05/2016 (month) in ('Alabama', 'Huntsville') (city) ?	1	0	0	0	1	1	0
3-102673	injuring		full_name	month	How many people were injured in 12/2016 (month) that involve the name Jeffery Webb (full_name) ?	3	2	2	0	1	0	5
3-76137	killing	state		month	How many people were killed in 12/2016 (month) in ('Alabama',) (state) ?	2	0	0	0	2	3	0
3-100495	injuring		first	year	How many people were injured in 2013 (year) that involve the name William (first) ?	5	3	3	0	2	1	6
3-102672	injuring		full_name	month	How many people were injured in 11/2014 (month) that involve the name Pedro Rosales (full_name) ?	4	3	3	0	1	0	9
3-103520	injuring		last	year	How many people were injured in 2015 (year) that involve the name Jabbar (last) ?	2	1	1	0	1	0	4
3-98380	injuring	state		month	How many people were injured in 06/2016 (month) in ('Minnesota',) (state) ?	3	4	3	1	0	8	11
3-99237	injuring	city		day	How many people were injured in 24/04/2016 (day) in ('Illinois', 'Chicago (Englewood)') (city) ?	1	0	0	0	1	3	0
3-98386	injuring	state		month	How many people were injured in 03/2015 (month) in ('Florida',) (state) ?	5	5	5	0	0	6	8
3-99235	injuring	city		day	How many people were injured in 11/03/2016 (day) in ('New Jersey', 'Trenton') (city) ?	2	1	1	0	1	5	4
3-87230	killing		last	month	How many people were killed in 06/2015 (month) that involve the name Daniels (last) ?	1	1	1	0	0	1	2
3-77428	killing	city		month	How many people were killed in 11/2013 (month) in ('Texas', 'Cypress') (city) ?	2	0	0	0	2	2	0
3-89412	killing	city	last		How many people were killed in ('Connecticut', 'New Haven') (city) that involve the name Ward (last) ?	4	0	0	0	4	0	0
3-103549	injuring		last	year	How many people were injured in 2016 (year) that involve the name Gildersleeve (last) ?	3	1	1	0	2	0	0
3-76100	killing	state		month	How many people were killed in 11/2016 (month) in ('Virginia',) (state) ?	5	2	2	0	3	6	4
3-98372	injuring	state		month	How many people were injured in 05/2016 (month) in ('Illinois',) (state) ?	4	3	1	2	3	6	8
3-75251	killing	city		day	How many people were killed in 10/03/2016 (day) in ('Mississippi', 'Vicksburg') (city) ?	2	0	0	0	2	1	0
3-96194	injuring	city		month	How many people were injured in 05/2016 (month) in ('Georgia', 'Jackson') (city) ?	1	0	0	0	1	3	0
3-77433	killing	city		month	How many people were killed in 12/2015 (month) in ('Texas', 'Universal City') (city) ?	2	0	0	0	2	1	0
3-99221	injuring	city		day	How many people were injured in 17/09/2016 (day) in ('Florida', 'Miami') (city) ?	2	1	1	0	1	6	1
3-96196	injuring	city		month	How many people were injured in 11/2016 (month) in ('California', 'Sacramento') (city) ?	2	2	2	0	0	5	4
3-98373	injuring	state		month	How many people were injured in 08/2015 (month) in ('Illinois',) (state) ?	6	5	3	2	3	15	15
3-76588	killing	state		day	How many people were killed in 16/11/2014 (day) in ('Colorado',) (state) ?	2	2	2	0	0	1	2
3-100044	injuring		first	year	How many people were injured in 2016 (year) that involve the name Brandon (first) ?	5	16	2	14	3	0	25
3-76106	killing	state		month	How many people were killed in 07/2016 (month) in ('Kentucky',) (state) ?	1	0	0	0	1	1	0
3-98370	injuring	state		month	How many people were injured in 10/2013 (month) in ('California',) (state) ?	3	3	3	0	0	18	8
3-75256	killing	city		day	How many people were killed in 05/08/2016 (day) in ('California', 'Perris') (city) ?	4	0	0	0	4	2	0
3-81925	killing		last	year	How many people were killed in 2015 (year) that involve the name Aguillard (last) ?	1	1	1	0	0	0	0
3-99222	injuring	city		day	How many people were injured in 04/07/2016 (day) in ('Pennsylvania', 'Pittsburgh') (city) ?	6	3	3	0	3	4	4
3-96199	injuring	city		month	How many people were injured in 12/2015 (month) in ('Georgia', 'Savannah') (city) ?	1	0	0	0	1	3	0
3-90876	killing	state	full_name		How many people were killed in ('Florida',) (state) that involve the name Johnny Davis (full_name) ?	3	2	2	0	1	1	0
3-87248	killing		last	month	How many people were killed in 08/2015 (month) that involve the name Epps (last) ?	2	2	2	0	0	1	1
3-93903	injuring	state		day	How many people were injured in 15/03/2016 (day) in ('Georgia',) (state) ?	1	1	1	0	0	5	5
3-107901	injuring	state	first		How many people were injured in ('Indiana',) (state) that involve the name Andrew (first) ?	3	3	0	3	3	1	2
3-102207	injuring		last	month	How many people were injured in 07/2015 (month) that involve the name Franklin (last) ?	7	3	3	0	4	0	2
3-103538	injuring		last	year	How many people were injured in 2016 (year) that involve the name Shavers (last) ?	2	0	0	0	2	1	0
3-102209	injuring		last	month	How many people were injured in 06/2014 (month) that involve the name Green (last) ?	1	1	1	0	0	0	3
3-111160	injuring	state	full_name		How many people were injured in ('New York',) (state) that involve the name Elijah Wells (full_name) ?	4	0	0	0	4	0	0
3-87244	killing		last	month	How many people were killed in 11/2016 (month) that involve the name Escobar (last) ?	1	1	1	0	0	1	2
3-100036	injuring		first	year	How many people were injured in 2016 (year) that involve the name Richard (first) ?	4	20	2	18	2	0	48
3-76111	killing	state		month	How many people were killed in 01/2015 (month) in ('Wisconsin',) (state) ?	2	2	2	0	0	2	5
3-99692	injuring	city		day	How many people were injured in 23/11/2016 (day) in ('Oklahoma', 'Oklahoma City') (city) ?	1	1	1	0	0	1	0
3-76113	killing	state		month	How many people were killed in 12/2015 (month) in ('Georgia',) (state) ?	2	1	1	0	1	2	1
3-98363	injuring	state		month	How many people were injured in 08/2015 (month) in ('Pennsylvania',) (state) ?	5	4	2	2	3	5	4
3-102212	injuring		last	month	How many people were injured in 09/2013 (month) that involve the name Pitts (last) ?	3	2	1	1	2	0	6
3-102696	injuring		full_name	month	How many people were injured in 11/2013 (month) that involve the name Bryan Williams (full_name) ?	2	1	1	0	1	0	6
3-96181	injuring	city		month	How many people were injured in 10/2015 (month) in ('South Carolina', 'Rock Hill') (city) ?	1	0	0	0	1	1	0
3-75268	killing	city		day	How many people were killed in 14/07/2016 (day) in ('Texas', 'Crosby') (city) ?	2	0	0	0	2	3	0
3-76593	killing	state		day	How many people were killed in 10/12/2016 (day) in ('South Carolina',) (state) ?	1	0	0	0	1	1	0
3-96188	injuring	city		month	How many people were injured in 11/2014 (month) in ('Florida', 'Deland') (city) ?	1	0	0	0	1	1	0
3-99697	injuring	city		day	How many people were injured in 30/05/2016 (day) in ('California', 'Sacramento') (city) ?	1	0	0	0	1	5	0
3-111112	injuring	state	full_name		How many people were injured in ('Maryland',) (state) that involve the name Donyae Jones (full_name) ?	3	2	1	1	2	0	2
3-110262	injuring	city	last		How many people were injured in ('New Jersey', 'Orange') (city) that involve the name Jones (last) ?	1	0	0	0	1	0	0
3-109278	injuring	city	full_name		How many people were injured in ('Illinois', 'Chicago (Englewood)') (city) that involve the name Vincent Ford (full_name) ?	2	0	0	0	2	1	0
3-76559	killing	state		day	How many people were killed in 02/11/2015 (day) in ('South Carolina',) (state) ?	1	0	0	0	1	4	0
3-77406	killing	city		month	How many people were killed in 06/2016 (month) in ('Texas', 'San Antonio') (city) ?	5	5	5	0	0	2	2
3-88546	killing	state	first		How many people were killed in ('Ohio',) (state) that involve the name Dewaun (first) ?	2	0	0	0	2	0	0
3-88545	killing	state	first		How many people were killed in ('Pennsylvania',) (state) that involve the name Christopher (first) ?	4	2	2	0	2	2	3
3-86364	killing		first	year	How many people were killed in 2014 (year) that involve the name Chad (first) ?	1	1	0	1	1	0	0
3-96171	injuring	city		month	How many people were injured in 11/2016 (month) in ('Louisiana', 'New Orleans') (city) ?	9	5	5	0	4	9	18
3-99681	injuring	city		day	How many people were injured in 30/05/2016 (day) in ('Maryland', 'Baltimore') (city) ?	2	0	0	0	2	5	0
3-99688	injuring	city		day	How many people were injured in 05/10/2013 (day) in ('California', 'Fresno') (city) ?	1	0	0	0	1	12	0
3-109270	injuring	city	full_name		How many people were injured in ('Texas', 'San Antonio') (city) that involve the name Joe Hernandez (full_name) ?	1	0	0	0	1	0	0
3-81902	killing		last	year	How many people were killed in 2016 (year) that involve the name Smith (last) ?	14	29	11	18	3	4	33
3-99201	injuring	city		day	How many people were injured in 19/04/2015 (day) in ('Virginia', 'Richmond') (city) ?	1	1	1	0	0	4	1
3-96176	injuring	city		month	How many people were injured in 05/2016 (month) in ('Minnesota', 'Minneapolis') (city) ?	4	3	3	0	1	8	12
3-75232	killing	city		day	How many people were killed in 16/10/2016 (day) in ('North Dakota', 'Bismarck') (city) ?	1	1	1	0	0	1	0
3-96177	injuring	city		month	How many people were injured in 10/2015 (month) in ('Pennsylvania', 'Erie') (city) ?	1	0	0	0	1	1	0
3-111101	injuring	state	full_name		How many people were injured in ('Texas',) (state) that involve the name Frederick Boise (full_name) ?	2	1	1	0	1	0	2
3-111588	job_firing		last	month	How many people were fired in 07/2015 (month) that involve the name Silva (last) ?	2	0	0	0	2	1	0
3-90854	killing	state	full_name		How many people were killed in ('Illinois',) (state) that involve the name Anthony Mendoza (full_name) ?	4	2	2	0	2	0	0
3-86379	killing		first	year	How many people were killed in 2016 (year) that involve the name Joseph (first) ?	3	6	1	5	2	1	10
3-111580	job_firing		last	month	How many people were fired in 09/2015 (month) that involve the name Vengesai (last) ?	1	1	1	0	0	1	1
3-89885	killing	city	full_name		How many people were killed in ('Arkansas', 'Little Rock') (city) that involve the name Jamie Clayton (full_name) ?	2	1	1	0	1	0	1
3-81910	killing		last	year	How many people were killed in 2016 (year) that involve the name Hernandez (last) ?	5	8	2	6	3	2	3
3-96162	injuring	city		month	How many people were injured in 05/2016 (month) in ('Alabama', 'Montgomery') (city) ?	1	0	0	0	1	3	0
3-100457	injuring		first	year	How many people were injured in 2016 (year) that involve the name Francisco (first) ?	1	0	0	0	1	0	0
3-103964	injuring		last	year	How many people were injured in 2015 (year) that involve the name Smith (last) ?	10	25	4	21	6	4	22
3-76576	killing	state		day	How many people were killed in 21/04/2016 (day) in ('Missouri',) (state) ?	1	0	0	0	1	1	0
3-96163	injuring	city		month	How many people were injured in 12/2014 (month) in ('Louisiana', 'New Orleans') (city) ?	1	0	0	0	1	4	0
3-78756	killing		first	month	How many people were killed in 10/2015 (month) that involve the name Kyle (first) ?	4	3	3	0	1	1	3
3-75249	killing	city		day	How many people were killed in 25/02/2016 (day) in ('North Carolina', 'Goldsboro') (city) ?	1	0	0	0	1	1	0
3-99677	injuring	city		day	How many people were injured in 06/01/2015 (day) in ('Florida', 'Miami') (city) ?	1	1	1	0	0	3	2
3-98343	injuring	state		month	How many people were injured in 11/2016 (month) in ('Pennsylvania',) (state) ?	4	12	4	8	0	8	21
3-81914	killing		last	year	How many people were killed in 2016 (year) that involve the name Guitierrez (last) ?	3	1	1	0	2	0	0
3-87670	killing		last	month	How many people were killed in 01/2015 (month) that involve the name Walker (last) ?	3	3	3	0	0	3	4
3-98329	injuring	state		month	How many people were injured in 04/2016 (month) in ('Maryland',) (state) ?	6	6	5	1	1	10	8
3-75207	killing	city		year	How many people were killed in 2015 (year) in ('Indiana', 'Paoli') (city) ?	1	0	0	0	1	3	0
3-87677	killing		last	month	How many people were killed in 02/2015 (month) that involve the name Littell (last) ?	1	1	1	0	0	1	1
3-84163	killing		full_name	month	How many people were killed in 11/2016 (month) that involve the name Alexander Mullins (full_name) ?	1	1	1	0	0	1	0
3-87672	killing		last	month	How many people were killed in 10/2016 (month) that involve the name Valencia (last) ?	2	1	1	0	1	3	0
3-100487	injuring		first	year	How many people were injured in 2016 (year) that involve the name Ryan (first) ?	2	10	1	9	1	0	8
3-77873	killing	city		month	How many people were killed in 07/2016 (month) in ('Texas', 'Conroe') (city) ?	1	1	1	0	0	2	0
3-103997	injuring		last	year	How many people were injured in 2016 (year) that involve the name Edwards (last) ?	4	9	4	5	0	0	16
3-111129	injuring	state	full_name		How many people were injured in ('Illinois',) (state) that involve the name Darian Tyler (full_name) ?	2	0	0	0	2	0	0
3-98331	injuring	state		month	How many people were injured in 12/2016 (month) in ('Massachusetts',) (state) ?	2	3	2	1	0	2	1
3-84171	killing		full_name	month	How many people were killed in 10/2016 (month) that involve the name Deandre Banks (full_name) ?	1	1	1	0	0	1	0
3-84170	killing		full_name	month	How many people were killed in 10/2016 (month) that involve the name Katylin Bellamy (full_name) ?	1	1	1	0	0	1	0
3-99648	injuring	city		day	How many people were injured in 28/06/2016 (day) in ('California', 'Los Angeles (county)') (city) ?	1	0	0	0	1	3	0
3-87687	killing		last	month	How many people were killed in 11/2016 (month) that involve the name Lander (last) ?	3	2	2	0	1	1	0
3-89866	killing	city	full_name		How many people were killed in ('Florida', 'Homestead (Florida City)') (city) that involve the name Curtis Hollinger (full_name) ?	2	0	0	0	2	0	0
3-101318	injuring		first	month	How many people were injured in 04/2014 (month) that involve the name Jordan (first) ?	1	1	1	0	0	0	2
3-76552	killing	state		day	How many people were killed in 11/02/2014 (day) in ('Wisconsin',) (state) ?	1	0	0	0	1	1	0
3-77400	killing	city		month	How many people were killed in 07/2016 (month) in ('Texas', 'Marion (county)') (city) ?	4	0	0	0	4	1	0
3-100479	injuring		first	year	How many people were injured in 2016 (year) that involve the name Ava (first) ?	5	3	3	0	2	1	2
3-100474	injuring		first	year	How many people were injured in 2013 (year) that involve the name Darren (first) ?	2	2	2	0	0	0	5
3-98324	injuring	state		month	How many people were injured in 08/2016 (month) in ('North Carolina',) (state) ?	4	3	1	2	3	4	3
3-75225	killing	city		day	How many people were killed in 17/09/2016 (day) in ('Indiana', 'Indianapolis') (city) ?	3	2	2	0	1	2	2
3-98327	injuring	state		month	How many people were injured in 11/2016 (month) in ('Tennessee',) (state) ?	6	5	4	1	2	16	16
3-99658	injuring	city		day	How many people were injured in 07/07/2015 (day) in ('Ohio', 'Cleveland') (city) ?	1	0	0	0	1	3	0
3-96149	injuring	city		month	How many people were injured in 09/2016 (month) in ('North Carolina', 'Wilmington') (city) ?	3	3	3	0	0	4	4
3-98321	injuring	state		month	How many people were injured in 09/2016 (month) in ('Florida',) (state) ?	3	6	3	3	0	7	8
3-99652	injuring	city		day	How many people were injured in 16/07/2015 (day) in ('Texas', 'Dallas') (city) ?	2	1	1	0	1	5	0
3-98320	injuring	state		month	How many people were injured in 07/2016 (month) in ('Colorado',) (state) ?	1	3	1	2	0	1	0
3-107970	injuring	state	first		How many people were injured in ('Tennessee',) (state) that involve the name Robert (first) ?	2	6	2	4	0	0	6
3-96249	injuring	city		month	How many people were injured in 02/2016 (month) in ('North Carolina', 'Knightdale') (city) ?	2	0	0	0	2	1	0
3-107973	injuring	state	first		How many people were injured in ('Florida',) (state) that involve the name Andrew (first) ?	1	1	1	0	0	1	4
3-85114	killing		full_name	day	How many people were killed in 11/09/2015 (day) that involve the name Nylique Knight (full_name) ?	4	0	0	0	4	0	0
3-108825	injuring	state	last		How many people were injured in ('Ohio',) (state) that involve the name Davis (last) ?	4	1	1	0	3	2	3
3-82086	killing		last	year	How many people were killed in 2016 (year) that involve the name Parks (last) ?	2	1	1	0	1	1	0
3-86437	killing		first	year	How many people were killed in 2014 (year) that involve the name Kevin (first) ?	3	4	3	1	0	2	5
3-78823	killing		first	month	How many people were killed in 11/2016 (month) that involve the name RaMaya (first) ?	3	1	1	0	2	1	0
3-96256	injuring	city		month	How many people were injured in 02/2015 (month) in ('California', 'Fresno') (city) ?	1	0	0	0	1	1	0
3-98434	injuring	state		month	How many people were injured in 02/2013 (month) in ('California',) (state) ?	11	8	8	0	3	11	8
3-104462	injuring		full_name	year	How many people were injured in 2015 (year) that involve the name Shallon Sales (full_name) ?	1	1	1	0	0	0	0
3-105792	injuring		last	day	How many people were injured in 15/10/2016 (day) that involve the name Brown (last) ?	2	2	1	1	1	0	7
3-75796	killing	city		day	How many people were killed in 20/03/2016 (day) in ('Illinois', 'Chicago (Englewood)') (city) ?	4	0	0	0	4	1	0
3-98431	injuring	state		month	How many people were injured in 04/2015 (month) in ('North Carolina',) (state) ?	4	3	3	0	1	5	0
3-75794	killing	city		day	How many people were killed in 13/03/2015 (day) in ('Mississippi', 'Brookhaven') (city) ?	2	0	0	0	2	2	0
3-96253	injuring	city		month	How many people were injured in 08/2016 (month) in ('California', 'Bakersfield') (city) ?	1	0	0	0	1	3	0
3-102281	injuring		last	month	How many people were injured in 11/2016 (month) that involve the name Hill (last) ?	4	1	1	0	3	1	3
3-86450	killing		first	year	How many people were killed in 2016 (year) that involve the name Pablo (first) ?	4	4	4	0	0	1	3
3-99748	injuring	city		day	How many people were injured in 25/11/2016 (day) in ('New Jersey', 'Monroe Township') (city) ?	2	0	0	0	2	2	0
3-96239	injuring	city		month	How many people were injured in 09/2016 (month) in ('Illinois', 'Joliet') (city) ?	2	0	0	0	2	2	0
3-99747	injuring	city		day	How many people were injured in 06/03/2016 (day) in ('California', 'Compton') (city) ?	2	1	1	0	1	8	10
3-86458	killing		first	year	How many people were killed in 2016 (year) that involve the name Diego (first) ?	7	4	4	0	3	3	4
3-86455	killing		first	year	How many people were killed in 2016 (year) that involve the name Daniel (first) ?	3	11	2	9	1	2	16
3-107967	injuring	state	first		How many people were injured in ('Florida',) (state) that involve the name Brady (first) ?	2	1	1	0	1	0	0
3-77501	killing	city		month	How many people were killed in 12/2016 (month) in ('Wisconsin', 'Milwaukee') (city) ?	3	2	2	0	1	2	1
3-85118	killing		full_name	day	How many people were killed in 11/12/2016 (day) that involve the name Jeffery Webb (full_name) ?	3	1	1	0	2	1	1
3-106632	injuring		first	day	How many people were injured in 25/12/2016 (day) that involve the name Roydricus (first) ?	1	1	1	0	0	0	4
3-98423	injuring	state		month	How many people were injured in 06/2015 (month) in ('Kentucky',) (state) ?	3	0	0	0	3	4	0
3-96247	injuring	city		month	How many people were injured in 03/2015 (month) in ('New Mexico', 'Albuquerque') (city) ?	4	3	3	0	1	6	8
3-98426	injuring	state		month	How many people were injured in 02/2015 (month) in ('Oregon',) (state) ?	1	0	0	0	1	1	0
3-100097	injuring		first	year	How many people were injured in 2016 (year) that involve the name William (first) ?	2	18	2	16	0	0	22
3-75323	killing	city		day	How many people were killed in 08/11/2016 (day) in ('Texas', 'Baytown') (city) ?	3	3	3	0	0	2	2
3-96242	injuring	city		month	How many people were injured in 06/2016 (month) in ('Minnesota', 'Minneapolis') (city) ?	1	2	1	1	0	4	3
3-99753	injuring	city		day	How many people were injured in 25/09/2016 (day) in ('Mississippi', 'Mccomb') (city) ?	1	0	0	0	1	1	0
3-96244	injuring	city		month	How many people were injured in 08/2015 (month) in ('Ohio', 'Cincinnati') (city) ?	2	0	0	0	2	5	0
3-99752	injuring	city		day	How many people were injured in 01/01/2013 (day) in ('California', 'Hawthorne') (city) ?	1	0	0	0	1	3	0
3-99739	injuring	city		day	How many people were injured in 19/06/2015 (day) in ('Minnesota', 'Felton') (city) ?	2	1	1	0	1	1	1
3-99738	injuring	city		day	How many people were injured in 25/01/2015 (day) in ('Nevada', 'Las Vegas') (city) ?	1	0	0	0	1	1	0
3-88603	killing	state	first		How many people were killed in ('Indiana',) (state) that involve the name Thomas (first) ?	6	4	4	0	2	2	4
3-86425	killing		first	year	How many people were killed in 2016 (year) that involve the name Joshua (first) ?	5	4	3	1	2	3	0
3-86422	killing		first	year	How many people were killed in 2016 (year) that involve the name Vincent (first) ?	4	3	2	1	2	1	2
3-88600	killing	state	first		How many people were killed in ('Pennsylvania',) (state) that involve the name Kenneth (first) ?	5	3	3	0	2	0	0
3-84237	killing		full_name	month	How many people were killed in 05/2016 (month) that involve the name Za'Layia Jenkins (full_name) ?	2	0	0	0	2	1	0
3-104003	injuring		last	year	How many people were injured in 2015 (year) that involve the name Stewart (last) ?	4	9	3	6	1	0	13
3-104487	injuring		full_name	year	How many people were injured in 2013 (year) that involve the name Demetrius Ward (full_name) ?	3	0	0	0	3	0	0
3-104004	injuring		last	year	How many people were injured in 2015 (year) that involve the name Harris (last) ?	6	3	2	1	4	1	4
3-106665	injuring		first	day	How many people were injured in 03/11/2016 (day) that involve the name Morlens (first) ?	3	2	2	0	1	0	1
3-98410	injuring	state		month	How many people were injured in 04/2014 (month) in ('District of Columbia',) (state) ?	1	0	0	0	1	4	0
3-99728	injuring	city		day	How many people were injured in 29/06/2014 (day) in ('Louisiana', 'New Orleans') (city) ?	5	1	1	0	4	9	9
3-78805	killing		first	month	How many people were killed in 10/2016 (month) that involve the name Christopher (first) ?	3	4	3	1	0	1	5
3-85588	killing		full_name	day	How many people were killed in 27/10/2016 (day) that involve the name Jermone Green (full_name) ?	2	1	1	0	1	1	0
3-107505	injuring	city	first		How many people were injured in ('Ohio', 'Cincinnati') (city) that involve the name Cameron (first) ?	2	0	0	0	2	1	0
3-76629	killing	state		day	How many people were killed in 14/11/2015 (day) in ('Arkansas',) (state) ?	2	2	2	0	0	1	1
3-84252	killing		full_name	month	How many people were killed in 12/2016 (month) that involve the name Sean Thomas (full_name) ?	1	1	1	0	0	0	0
3-78810	killing		first	month	How many people were killed in 11/2016 (month) that involve the name Kenneth (first) ?	1	1	1	0	0	0	0
3-103146	injuring		full_name	month	How many people were injured in 06/2013 (month) that involve the name Que’sean Brown (full_name) ?	1	0	0	0	1	1	0
3-93197	killing	state	last		How many people were killed in ('Pennsylvania',) (state) that involve the name Murphy (last) ?	3	2	2	0	1	0	0
3-98402	injuring	state		month	How many people were injured in 10/2015 (month) in ('South Carolina',) (state) ?	2	1	1	0	1	5	4
3-98885	injuring	city		day	How many people were injured in 10/10/2015 (day) in ('North Carolina', 'Charlotte') (city) ?	2	0	0	0	2	4	0
3-93195	killing	state	last		How many people were killed in ('Florida',) (state) that involve the name Wright (last) ?	3	2	2	0	1	1	0
3-99734	injuring	city		day	How many people were injured in 22/11/2016 (day) in ('Florida', 'Miami') (city) ?	3	2	2	0	1	2	2
3-102290	injuring		last	month	How many people were injured in 04/2016 (month) that involve the name Valle (last) ?	1	1	1	0	0	0	0
3-98884	injuring	city		day	How many people were injured in 15/05/2015 (day) in ('Louisiana', 'Baton Rouge') (city) ?	1	0	0	0	1	1	0
3-81192	killing		full_name	year	How many people were killed in 2015 (year) that involve the name Luke Burns (full_name) ?	1	1	1	0	0	1	0
3-98867	injuring	state		year	How many people were injured in 2015 (year) in ('Arkansas',) (state) ?	5	23	5	18	0	5	25
3-75746	killing	city		day	How many people were killed in 25/05/2016 (day) in ('Washington', 'Seattle') (city) ?	2	1	1	0	1	1	0
3-98869	injuring	state		year	How many people were injured in 2014 (year) in ('Mississippi',) (state) ?	4	2	2	0	2	10	5
3-83376	killing		last	day	How many people were killed in 05/12/2016 (day) that involve the name Aitch (last) ?	1	1	1	0	0	1	2
3-86887	killing		last	month	How many people were killed in 10/2016 (month) that involve the name Zweck (last) ?	4	1	1	0	3	0	0
3-83371	killing		last	day	How many people were killed in 05/09/2016 (day) that involve the name Setter (last) ?	2	1	1	0	1	1	0
3-83373	killing		last	day	How many people were killed in 17/07/2016 (day) that involve the name Long (last) ?	1	1	1	0	0	1	0
3-106605	injuring		first	day	How many people were injured in 28/07/2016 (day) that involve the name Zecary (first) ?	3	1	1	0	2	0	5
3-107929	injuring	state	first		How many people were injured in ('Maryland',) (state) that involve the name Deshaun (first) ?	2	2	2	0	0	0	7
3-103579	injuring		last	year	How many people were injured in 2016 (year) that involve the name Carroll (last) ?	3	5	3	2	0	0	4
3-101397	injuring		first	month	How many people were injured in 01/2015 (month) that involve the name Christina (first) ?	3	4	2	2	1	1	0
3-106602	injuring		first	day	How many people were injured in 08/10/2016 (day) that involve the name Ivan (first) ?	2	0	0	0	2	0	0
3-89903	killing	city	full_name		How many people were killed in ('Pennsylvania', 'Philadelphia') (city) that involve the name Ian Wilsey (full_name) ?	3	3	3	0	0	1	1
3-101398	injuring		first	month	How many people were injured in 11/2015 (month) that involve the name Sylvia (first) ?	1	0	0	0	1	0	0
3-98875	injuring	city		day	How many people were injured in 09/12/2016 (day) in ('California', 'Fresno') (city) ?	2	2	2	0	0	4	4
3-98877	injuring	city		day	How many people were injured in 01/03/2015 (day) in ('Florida', 'Orange County') (city) ?	1	0	0	0	1	4	0
3-75751	killing	city		day	How many people were killed in 11/12/2016 (day) in ('Florida', 'Miami Gardens') (city) ?	1	1	1	0	0	2	2
3-98871	injuring	state		year	How many people were injured in 2015 (year) in ('Florida',) (state) ?	32	33	26	7	6	53	44
3-98870	injuring	state		year	How many people were injured in 2015 (year) in ('Georgia',) (state) ?	20	19	12	7	8	24	34
3-98872	injuring	state		year	How many people were injured in 2015 (year) in ('Colorado',) (state) ?	4	9	4	5	0	5	3
3-94018	injuring	state		day	How many people were injured in 04/07/2016 (day) in ('Texas',) (state) ?	5	3	3	0	2	2	8
3-98857	injuring	state		year	How many people were injured in 2015 (year) in ('New Mexico',) (state) ?	6	5	5	0	1	8	9
3-75757	killing	city		day	How many people were killed in 24/03/2015 (day) in ('Indiana', 'Indianapolis') (city) ?	1	0	0	0	1	4	0
3-98859	injuring	state		year	How many people were injured in 2014 (year) in ('North Carolina',) (state) ?	3	2	1	1	2	6	2
3-98858	injuring	state		year	How many people were injured in 2013 (year) in ('Pennsylvania',) (state) ?	12	10	8	2	4	32	37
3-107916	injuring	state	first		How many people were injured in ('Louisiana',) (state) that involve the name Corey (first) ?	11	2	2	0	9	1	3
3-86408	killing		first	year	How many people were killed in 2015 (year) that involve the name Justin (first) ?	5	5	3	2	2	1	3
3-100054	injuring		first	year	How many people were injured in 2015 (year) that involve the name Vincent (first) ?	4	5	3	2	1	0	2
3-103565	injuring		last	year	How many people were injured in 2016 (year) that involve the name Brown (last) ?	26	32	15	17	11	6	65
3-101387	injuring		first	month	How many people were injured in 10/2016 (month) that involve the name James (first) ?	4	2	1	1	3	0	0
3-96201	injuring	city		month	How many people were injured in 09/2015 (month) in ('Michigan', 'Albion') (city) ?	2	0	0	0	2	4	0
3-98864	injuring	state		year	How many people were injured in 2016 (year) in ('Virginia',) (state) ?	22	18	14	4	8	24	10
3-99711	injuring	city		day	How many people were injured in 31/12/2015 (day) in ('Louisiana', 'New Orleans') (city) ?	1	1	1	0	0	6	5
3-102231	injuring		last	month	How many people were injured in 12/2016 (month) that involve the name Williams (last) ?	2	2	2	0	0	0	4
3-96203	injuring	city		month	How many people were injured in 08/2016 (month) in ('Georgia', 'Atlanta') (city) ?	1	2	1	1	0	3	3
3-99713	injuring	city		day	How many people were injured in 28/09/2015 (day) in ('Ohio', 'Dayton') (city) ?	1	1	1	0	0	4	4
3-99712	injuring	city		day	How many people were injured in 18/05/2016 (day) in ('South Dakota', 'Sioux Falls') (city) ?	1	1	1	0	0	1	0
3-94026	injuring	state		day	How many people were injured in 25/09/2016 (day) in ('Illinois',) (state) ?	7	5	5	0	2	5	10
3-98860	injuring	state		year	How many people were injured in 2016 (year) in ('Nebraska',) (state) ?	2	6	0	6	2	2	5
3-98862	injuring	state		year	How many people were injured in 2016 (year) in ('Tennessee',) (state) ?	39	44	27	17	12	39	47
3-98861	injuring	state		year	How many people were injured in 2014 (year) in ('Virginia',) (state) ?	4	7	3	4	1	18	11
3-75729	killing	city		day	How many people were killed in 24/06/2014 (day) in ('Florida', 'Miami') (city) ?	2	2	2	0	0	2	4
3-94007	injuring	state		day	How many people were injured in 12/11/2016 (day) in ('Connecticut',) (state) ?	1	1	1	0	0	5	1
3-98849	injuring	state		year	How many people were injured in 2014 (year) in ('Colorado',) (state) ?	3	5	3	2	0	8	13
3-94006	injuring	state		day	How many people were injured in 30/06/2013 (day) in ('Colorado',) (state) ?	1	0	0	0	1	4	0
3-74879	killing	city		year	How many people were killed in 2016 (year) in ('Ohio', 'Toledo') (city) ?	7	6	4	2	3	3	6
3-98845	injuring	state		year	How many people were injured in 2015 (year) in ('Alabama',) (state) ?	8	6	5	1	3	18	12
3-96669	injuring	city		month	How many people were injured in 03/2013 (month) in ('California', 'Modesto') (city) ?	2	2	2	0	0	4	4
3-98848	injuring	state		year	How many people were injured in 2013 (year) in ('Tennessee',) (state) ?	6	4	4	0	2	13	12
3-98847	injuring	state		year	How many people were injured in 2015 (year) in ('Connecticut',) (state) ?	7	5	4	1	3	4	8
3-107952	injuring	state	first		How many people were injured in ('Florida',) (state) that involve the name David (first) ?	3	5	1	4	2	1	4
3-82022	killing		last	year	How many people were killed in 2016 (year) that involve the name Gill (last) ?	1	5	1	4	0	2	2
3-107953	injuring	state	first		How many people were injured in ('New York',) (state) that involve the name Floyd (first) ?	3	0	0	0	3	0	0
3-81177	killing		full_name	year	How many people were killed in 2016 (year) that involve the name Jaylen Howard (full_name) ?	1	1	1	0	0	1	0
3-82019	killing		last	year	How many people were killed in 2015 (year) that involve the name Robinson (last) ?	5	1	0	1	5	1	0
3-94491	injuring	city		year	How many people were injured in 2015 (year) in ('Pennsylvania', 'Erie') (city) ?	6	0	0	0	6	5	0
3-103596	injuring		last	year	How many people were injured in 2015 (year) that involve the name Curtis (last) ?	2	2	2	0	0	0	6
3-106620	injuring		first	day	How many people were injured in 13/07/2016 (day) that involve the name Ernest (first) ?	3	3	2	1	1	0	2
3-98853	injuring	state		year	How many people were injured in 2015 (year) in ('Arizona',) (state) ?	6	5	5	0	1	9	7
3-94010	injuring	state		day	How many people were injured in 20/02/2016 (day) in ('Florida',) (state) ?	4	4	4	0	0	7	6
3-94494	injuring	city		year	How many people were injured in 2015 (year) in ('Louisiana', 'Shreveport') (city) ?	1	8	0	8	1	4	3
3-98852	injuring	state		year	How many people were injured in 2016 (year) in ('Delaware',) (state) ?	4	26	1	25	3	6	36
3-102264	injuring		last	month	How many people were injured in 12/2015 (month) that involve the name Johnson (last) ?	2	3	1	2	1	0	6
3-94493	injuring	city		year	How many people were injured in 2016 (year) in ('Kansas', 'Wichita') (city) ?	4	2	0	2	4	6	0
3-98855	injuring	state		year	How many people were injured in 2016 (year) in ('Michigan',) (state) ?	45	29	22	7	23	45	29
3-74883	killing	city		year	How many people were killed in 2016 (year) in ('Virginia', 'Charlotte (county)') (city) ?	1	0	0	0	1	1	0
3-94492	injuring	city		year	How many people were injured in 2015 (year) in ('Louisiana', 'New Orleans') (city) ?	6	5	5	0	1	14	11
3-98854	injuring	state		year	How many people were injured in 2016 (year) in ('District of Columbia',) (state) ?	4	30	0	30	4	7	53
3-94015	injuring	state		day	How many people were injured in 17/08/2016 (day) in ('California',) (state) ?	1	0	0	0	1	4	0
3-94497	injuring	city		year	How many people were injured in 2016 (year) in ('Missouri', 'Kansas City') (city) ?	6	7	3	4	3	10	8
3-98851	injuring	state		year	How many people were injured in 2016 (year) in ('Maine',) (state) ?	2	5	2	3	0	2	5
3-94496	injuring	city		year	How many people were injured in 2016 (year) in ('Texas', 'Austin') (city) ?	13	11	7	4	6	7	15
3-98839	injuring	state		year	How many people were injured in 2014 (year) in ('Michigan',) (state) ?	12	3	3	0	9	32	7
3-75739	killing	city		day	How many people were killed in 21/06/2015 (day) in ('Utah', 'Roy') (city) ?	2	0	0	0	2	4	0
3-94478	injuring	city		year	How many people were injured in 2016 (year) in ('Mississippi', 'Jackson') (city) ?	3	7	2	5	1	7	17
3-96656	injuring	city		month	How many people were injured in 11/2014 (month) in ('Maryland', 'Baltimore') (city) ?	1	0	0	0	1	1	0
3-96657	injuring	city		month	How many people were injured in 07/2015 (month) in ('Michigan', 'Saginaw') (city) ?	1	0	0	0	1	2	0
3-98837	injuring	state		year	How many people were injured in 2016 (year) in ('New Jersey',) (state) ?	25	26	15	11	10	48	36
3-98836	injuring	state		year	How many people were injured in 2014 (year) in ('Pennsylvania',) (state) ?	9	9	8	1	1	27	22
3-84212	killing		full_name	month	How many people were killed in 12/2016 (month) that involve the name Jahleel Brown (full_name) ?	2	0	0	0	2	0	0
3-84698	killing		full_name	month	How many people were killed in 09/2016 (month) that involve the name Larriana Hughes (full_name) ?	1	1	1	0	0	0	0
3-107944	injuring	state	first		How many people were injured in ('Texas',) (state) that involve the name Raymundo (first) ?	1	1	1	0	0	0	0
3-82032	killing		last	year	How many people were killed in 2015 (year) that involve the name Lewis (last) ?	5	10	5	5	0	2	10
3-104439	injuring		full_name	year	How many people were injured in 2016 (year) that involve the name Joshua Karban (full_name) ?	1	1	1	0	0	0	0
3-87718	killing		last	month	How many people were killed in 09/2014 (month) that involve the name Wilson (last) ?	1	1	1	0	0	1	1
3-103103	injuring		full_name	month	How many people were injured in 02/2016 (month) that involve the name Jeffery Eckstein (full_name) ?	1	1	1	0	0	0	0
3-103102	injuring		full_name	month	How many people were injured in 02/2016 (month) that involve the name Manuel Otiz (full_name) ?	2	1	1	0	1	0	2
3-103586	injuring		last	year	How many people were injured in 2016 (year) that involve the name Fauntleroy (last) ?	3	1	1	0	2	0	0
3-82029	killing		last	year	How many people were killed in 2016 (year) that involve the name Phillips (last) ?	4	8	4	4	0	1	3
3-94000	injuring	state		day	How many people were injured in 20/02/2016 (day) in ('Michigan',) (state) ?	2	1	1	0	1	1	0
3-94484	injuring	city		year	How many people were injured in 2015 (year) in ('Louisiana', 'Baton Rouge') (city) ?	3	4	3	1	0	3	6
3-96663	injuring	city		month	How many people were injured in 10/2016 (month) in ('Louisiana', 'New Orleans') (city) ?	1	1	0	1	1	1	6
3-98842	injuring	state		year	How many people were injured in 2016 (year) in ('North Carolina',) (state) ?	33	28	20	8	13	44	34
3-100074	injuring		first	year	How many people were injured in 2016 (year) that involve the name Herbert (first) ?	2	4	2	2	0	0	1
3-94482	injuring	city		year	How many people were injured in 2013 (year) in ('New York', 'New York') (city) ?	2	0	0	0	2	4	0
3-96665	injuring	city		month	How many people were injured in 11/2015 (month) in ('California', 'Fresno') (city) ?	3	0	0	0	3	6	0
3-98844	injuring	state		year	How many people were injured in 2016 (year) in ('Ohio',) (state) ?	30	56	23	33	7	30	62
3-96660	injuring	city		month	How many people were injured in 11/2016 (month) in ('Texas', 'San Antonio') (city) ?	4	4	4	0	0	8	12
3-74891	killing	city		year	How many people were killed in 2016 (year) in ('Ohio', 'Amelia') (city) ?	2	0	0	0	2	1	0
3-98840	injuring	state		year	How many people were injured in 2013 (year) in ('Arizona',) (state) ?	5	2	2	0	3	12	8
3-98828	injuring	state		year	How many people were injured in 2015 (year) in ('New Jersey',) (state) ?	7	6	5	1	2	16	11
3-98829	injuring	state		year	How many people were injured in 2013 (year) in ('Texas',) (state) ?	7	11	7	4	0	22	22
3-98824	injuring	state		year	How many people were injured in 2015 (year) in ('Virginia',) (state) ?	7	11	5	6	2	13	7
3-110742	injuring	state	full_name		How many people were injured in ('New Jersey',) (state) that involve the name Hanayah Woods (full_name) ?	1	1	1	0	0	0	0
3-74854	killing	city		year	How many people were killed in 2016 (year) in ('Missouri', 'Kansas City') (city) ?	10	5	5	0	5	6	2
3-98825	injuring	state		year	How many people were injured in 2015 (year) in ('South Carolina',) (state) ?	3	3	1	2	2	6	11
3-82001	killing		last	year	How many people were killed in 2013 (year) that involve the name Williams (last) ?	4	4	2	2	2	3	4
3-85996	killing		first	year	How many people were killed in 2016 (year) that involve the name Javon (first) ?	4	2	2	0	2	2	3
3-100938	injuring		first	month	How many people were injured in 10/2016 (month) that involve the name Jose (first) ?	3	3	2	1	1	2	7
3-80299	killing		first	day	How many people were killed in 27/11/2016 (day) that involve the name John (first) ?	3	2	2	0	1	0	0
3-81146	killing		full_name	year	How many people were killed in 2016 (year) that involve the name Mahsaan Kelley-Wilson (full_name) ?	2	1	1	0	1	1	0
3-86836	killing		last	month	How many people were killed in 04/2016 (month) that involve the name Laboy (last) ?	3	1	1	0	2	1	0
3-98831	injuring	state		year	How many people were injured in 2015 (year) in ('Pennsylvania',) (state) ?	36	26	23	3	13	67	40
3-98830	injuring	state		year	How many people were injured in 2015 (year) in ('Mississippi',) (state) ?	9	10	6	4	3	10	6
3-98832	injuring	state		year	How many people were injured in 2013 (year) in ('Colorado',) (state) ?	2	1	1	0	1	9	4
3-94477	injuring	city		year	How many people were injured in 2015 (year) in ('Colorado', 'Aurora') (city) ?	2	2	2	0	0	1	0
3-94476	injuring	city		year	How many people were injured in 2016 (year) in ('North Carolina', 'Rocky Mount') (city) ?	2	0	0	0	2	5	0
3-94475	injuring	city		year	How many people were injured in 2015 (year) in ('North Carolina', 'Stokes') (city) ?	1	0	0	0	1	1	0
3-96650	injuring	city		month	How many people were injured in 07/2013 (month) in ('Florida', 'Pompano Beach') (city) ?	2	2	2	0	0	3	4
3-93143	killing	state	last		How many people were killed in ('Ohio',) (state) that involve the name Hayes (last) ?	1	1	1	0	0	1	0
3-94474	injuring	city		year	How many people were injured in 2014 (year) in ('California', 'Bellflower') (city) ?	2	0	0	0	2	2	0
3-98817	injuring	state		year	How many people were injured in 2016 (year) in ('Connecticut',) (state) ?	19	13	10	3	9	37	21
3-98816	injuring	state		year	How many people were injured in 2014 (year) in ('South Carolina',) (state) ?	4	5	3	2	1	7	10
3-98818	injuring	state		year	How many people were injured in 2016 (year) in ('Colorado',) (state) ?	11	21	7	14	4	5	19
3-74868	killing	city		year	How many people were killed in 2013 (year) in ('New York', 'Mohawk') (city) ?	3	0	0	0	3	6	0
3-95788	injuring	city		month	How many people were injured in 06/2015 (month) in ('Maryland', 'Baltimore') (city) ?	1	0	0	0	1	1	0
3-98812	injuring	state		year	How many people were injured in 2014 (year) in ('Washington',) (state) ?	4	7	1	6	3	5	17
3-98815	injuring	state		year	How many people were injured in 2015 (year) in ('Idaho',) (state) ?	2	4	1	3	1	2	8
3-107566	injuring	state	first		How many people were injured in ('Texas',) (state) that involve the name Eugene (first) ?	1	1	1	0	0	0	6
3-96637	injuring	city		month	How many people were injured in 09/2016 (month) in ('Arkansas', 'Hot Springs National Park (Hot Springs)') (city) ?	3	0	0	0	3	4	0
3-98814	injuring	state		year	How many people were injured in 2013 (year) in ('Michigan',) (state) ?	7	1	1	0	6	25	5
3-108414	injuring	state	last		How many people were injured in ('Illinois',) (state) that involve the name Jones (last) ?	2	1	0	1	2	0	2
3-83342	killing		last	day	How many people were killed in 28/06/2016 (day) that involve the name Rodriguez (last) ?	3	3	3	0	0	0	0
3-109746	injuring	city	last		How many people were injured in ('Pennsylvania', 'Philadelphia') (city) that involve the name Harley (last) ?	2	1	1	0	1	0	2
3-83343	killing		last	day	How many people were killed in 04/10/2016 (day) that involve the name Andrews (last) ?	2	2	2	0	0	1	2
3-108416	injuring	state	last		How many people were injured in ('Illinois',) (state) that involve the name Tanner (last) ?	1	0	0	0	1	1	0
3-82013	killing		last	year	How many people were killed in 2016 (year) that involve the name Lara (last) ?	7	3	3	0	4	2	5
3-82008	killing		last	year	How many people were killed in 2016 (year) that involve the name Powell (last) ?	2	5	2	3	0	3	4
3-104058	injuring		last	year	How many people were injured in 2015 (year) that involve the name Brown (last) ?	5	9	2	7	3	0	11
3-106237	injuring		first	day	How many people were injured in 17/07/2016 (day) that involve the name Edward (first) ?	1	1	1	0	0	0	3
3-86844	killing		last	month	How many people were killed in 11/2016 (month) that involve the name Malone (last) ?	7	3	3	0	4	1	2
3-86845	killing		last	month	How many people were killed in 01/2015 (month) that involve the name Mata (last) ?	2	2	2	0	0	2	3
3-105388	injuring		full_name	day	How many people were injured in 07/08/2016 (day) that involve the name Brandon Karr (full_name) ?	1	1	1	0	0	0	2
3-75722	killing	city		day	How many people were killed in 30/07/2015 (day) in ('Texas', 'Houston') (city) ?	2	2	2	0	0	1	3
3-96641	injuring	city		month	How many people were injured in 08/2016 (month) in ('Indiana', 'Evansville') (city) ?	4	0	0	0	4	4	0
3-98820	injuring	state		year	How many people were injured in 2016 (year) in ('Florida',) (state) ?	58	79	44	35	14	73	86
3-98822	injuring	state		year	How many people were injured in 2015 (year) in ('Illinois',) (state) ?	34	20	12	8	22	72	37
3-96644	injuring	city		month	How many people were injured in 10/2014 (month) in ('North Carolina', 'Rutherford County') (city) ?	1	0	0	0	1	1	0
3-98821	injuring	state		year	How many people were injured in 2016 (year) in ('Idaho',) (state) ?	5	5	5	0	0	4	3
3-94466	injuring	city		year	How many people were injured in 2016 (year) in ('Indiana', 'Evansville') (city) ?	5	0	0	0	5	8	0
3-94463	injuring	city		year	How many people were injured in 2016 (year) in ('Illinois', 'Chicago (Englewood)') (city) ?	8	24	4	20	4	14	23
3-106260	injuring		first	day	How many people were injured in 12/11/2016 (day) that involve the name Maige (first) ?	2	1	1	0	1	0	4
3-94448	injuring	city		year	How many people were injured in 2015 (year) in ('Massachusetts', 'Boston') (city) ?	4	3	3	0	1	9	6
3-74838	killing	city		year	How many people were killed in 2015 (year) in ('Missouri', 'Eureka') (city) ?	1	0	0	0	1	2	0
3-94447	injuring	city		year	How many people were injured in 2016 (year) in ('New York', 'Mount Vernon') (city) ?	4	1	1	0	3	5	5
3-98808	injuring	state		year	How many people were injured in 2013 (year) in ('California',) (state) ?	39	27	24	3	15	83	54
3-98807	injuring	state		year	How many people were injured in 2015 (year) in ('New York',) (state) ?	32	0	0	0	32	55	0
3-98802	injuring	state		year	How many people were injured in 2013 (year) in ('Kentucky',) (state) ?	2	2	2	0	0	5	4
3-108444	injuring	state	last		How many people were injured in ('Arkansas',) (state) that involve the name Williams (last) ?	3	2	2	0	1	1	6
3-110764	injuring	state	full_name		How many people were injured in ('Tennessee',) (state) that involve the name Tyson Lucas (full_name) ?	2	2	2	0	0	1	0
3-96624	injuring	city		month	How many people were injured in 09/2016 (month) in ('Texas', 'Houston') (city) ?	9	7	6	1	3	9	20
3-109776	injuring	city	last		How many people were injured in ('Georgia', 'Jackson') (city) that involve the name Hastings (last) ?	1	0	0	0	1	0	0
3-107599	injuring	state	first		How many people were injured in ('Maryland',) (state) that involve the name Derrick (first) ?	3	1	1	0	2	0	0
3-79291	killing		first	month	How many people were killed in 08/2016 (month) that involve the name Brandon (first) ?	3	3	1	2	2	0	0
3-94449	injuring	city		year	How many people were injured in 2016 (year) in ('North Carolina', 'Durham') (city) ?	3	0	0	0	3	4	0
3-98803	injuring	state		year	How many people were injured in 2016 (year) in ('Arkansas',) (state) ?	12	22	7	15	5	18	36
3-80282	killing		first	day	How many people were killed in 17/10/2016 (day) that involve the name Keagan (first) ?	2	0	0	0	2	1	0
3-82464	killing		last	year	How many people were killed in 2016 (year) that involve the name Carter (last) ?	3	6	3	3	0	2	5
3-83312	killing		last	day	How many people were killed in 07/11/2013 (day) that involve the name Williams (last) ?	2	0	0	0	2	2	0
3-98809	injuring	state		year	How many people were injured in 2015 (year) in ('Washington',) (state) ?	7	11	5	6	2	5	5
3-82461	killing		last	year	How many people were killed in 2016 (year) that involve the name Freeman (last) ?	4	4	3	1	1	2	1
3-81129	killing		full_name	year	How many people were killed in 2016 (year) that involve the name Bianca Arter (full_name) ?	1	1	1	0	0	1	2
3-85967	killing		first	year	How many people were killed in 2016 (year) that involve the name Christian (first) ?	6	7	4	3	2	2	7
3-104087	injuring		last	year	How many people were injured in 2016 (year) that involve the name Smith (last) ?	15	41	10	31	5	5	52
3-74840	killing	city		year	How many people were killed in 2016 (year) in ('New Jersey', 'Orange') (city) ?	4	0	0	0	4	3	0
3-95785	injuring	city		month	How many people were injured in 11/2016 (month) in ('Tennessee', 'Dyersburg') (city) ?	3	1	1	0	2	7	7
3-96632	injuring	city		month	How many people were injured in 04/2013 (month) in ('California', 'Vallejo') (city) ?	1	0	0	0	1	4	0
3-98811	injuring	state		year	How many people were injured in 2015 (year) in ('Oklahoma',) (state) ?	4	6	3	3	1	12	8
3-95786	injuring	city		month	How many people were injured in 04/2016 (month) in ('Washington', 'Lakewood') (city) ?	2	0	0	0	2	1	0
3-98810	injuring	state		year	How many people were injured in 2016 (year) in ('Kansas',) (state) ?	7	10	2	8	5	9	1
3-94452	injuring	city		year	How many people were injured in 2016 (year) in ('Colorado', 'Denver') (city) ?	7	6	4	2	3	2	7
3-96618	injuring	city		month	How many people were injured in 06/2015 (month) in ('Indiana', 'Indianapolis') (city) ?	1	1	1	0	0	1	0
3-96619	injuring	city		month	How many people were injured in 12/2016 (month) in ('New Jersey', 'Bloomfield') (city) ?	1	0	0	0	1	6	0
3-95765	injuring	city		month	How many people were injured in 07/2016 (month) in ('Texas', 'Houston') (city) ?	6	9	6	3	0	5	14
3-96612	injuring	city		month	How many people were injured in 12/2015 (month) in ('Nebraska', 'Omaha') (city) ?	1	0	0	0	1	3	0
3-74845	killing	city		year	How many people were killed in 2016 (year) in ('Georgia', 'Jonesboro') (city) ?	1	0	0	0	1	2	0
3-95768	injuring	city		month	How many people were injured in 08/2013 (month) in ('New Jersey', 'Montclair') (city) ?	1	1	1	0	0	4	4
3-96615	injuring	city		month	How many people were injured in 08/2015 (month) in ('Maryland', 'Baltimore') (city) ?	1	1	1	0	0	7	7
3-85982	killing		first	year	How many people were killed in 2016 (year) that involve the name Oliver (first) ?	4	2	2	0	2	1	2
3-80296	killing		first	day	How many people were killed in 09/12/2016 (day) that involve the name Christopher (first) ?	1	1	1	0	0	1	3
3-96621	injuring	city		month	How many people were injured in 05/2015 (month) in ('California', 'San Diego') (city) ?	1	1	1	0	0	4	4
3-104074	injuring		last	year	How many people were injured in 2015 (year) that involve the name Johnson (last) ?	5	12	3	9	2	0	23
3-74817	killing	city		year	How many people were killed in 2016 (year) in ('Texas', 'Austin') (city) ?	13	9	6	3	7	2	4
3-95759	injuring	city		month	How many people were injured in 02/2015 (month) in ('Arkansas', 'Little Rock') (city) ?	2	2	2	0	0	3	6
3-93577	injuring	state		day	How many people were injured in 14/07/2016 (day) in ('Ohio',) (state) ?	1	1	1	0	0	3	3
3-107531	injuring	city	first		How many people were injured in ('Texas', 'Houston') (city) that involve the name Braveon (first) ?	2	1	1	0	1	0	3
3-108864	injuring	state	last		How many people were injured in ('Ohio',) (state) that involve the name Lindsey (last) ?	3	2	2	0	1	0	1
3-82440	killing		last	year	How many people were killed in 2016 (year) that involve the name Cole (last) ?	3	9	2	7	1	2	2
3-85950	killing		first	year	How many people were killed in 2016 (year) that involve the name Rafael (first) ?	3	1	1	0	2	1	1
3-108866	injuring	state	last		How many people were injured in ('Florida',) (state) that involve the name Clark (last) ?	1	1	1	0	0	0	0
3-107538	injuring	city	first		How many people were injured in ('Florida', 'Miami') (city) that involve the name Angel (first) ?	6	1	1	0	5	2	0
3-74819	killing	city		year	How many people were killed in 2016 (year) in ('Georgia', 'Savannah') (city) ?	1	0	0	0	1	1	0
3-82438	killing		last	year	How many people were killed in 2016 (year) that involve the name Johnson (last) ?	19	28	11	17	8	6	27
3-85943	killing		first	year	How many people were killed in 2014 (year) that involve the name Keshira (first) ?	2	1	1	0	1	1	2
3-106202	injuring		last	day	How many people were injured in 28/11/2016 (day) that involve the name Martinez (last) ?	1	0	0	0	1	2	0
3-95761	injuring	city		month	How many people were injured in 08/2016 (month) in ('Connecticut', 'Waterbury') (city) ?	1	0	0	0	1	4	0
3-104024	injuring		last	year	How many people were injured in 2016 (year) that involve the name Turner (last) ?	1	8	1	7	0	0	12
3-96611	injuring	city		month	How many people were injured in 12/2015 (month) in ('California', 'Huntington Beach') (city) ?	1	1	1	0	0	4	4
3-79276	killing		first	month	How many people were killed in 11/2016 (month) that involve the name Richard (first) ?	4	3	2	1	2	1	1
3-93586	injuring	state		day	How many people were injured in 27/11/2016 (day) in ('Missouri',) (state) ?	1	1	1	0	0	7	7
3-77098	killing	state		day	How many people were killed in 19/11/2016 (day) in ('Pennsylvania',) (state) ?	2	2	2	0	0	3	3
3-84619	killing		full_name	month	How many people were killed in 12/2015 (month) that involve the name Raheem Shannon (full_name) ?	1	1	1	0	0	1	5
3-93584	injuring	state		day	How many people were injured in 11/08/2013 (day) in ('Virginia',) (state) ?	1	1	1	0	0	4	4
3-94430	injuring	state		day	How many people were injured in 28/06/2015 (day) in ('Michigan',) (state) ?	2	2	0	2	2	5	2
3-94415	injuring	state		day	How many people were injured in 28/08/2016 (day) in ('New York',) (state) ?	1	0	0	0	1	4	0
3-93567	injuring	state		day	How many people were injured in 28/05/2013 (day) in ('Tennessee',) (state) ?	1	0	0	0	1	3	0
3-90059	killing	city	full_name		How many people were killed in ('Michigan', 'Detroit') (city) that involve the name Tkira Steen (full_name) ?	2	0	0	0	2	0	0
3-94413	injuring	state		day	How many people were injured in 24/07/2015 (day) in ('Pennsylvania',) (state) ?	5	0	0	0	5	4	0
3-94897	injuring	city		year	How many people were injured in 2016 (year) in ('California', 'Oakland') (city) ?	10	0	0	0	10	32	0
3-90058	killing	city	full_name		How many people were killed in ('California', 'Perris') (city) that involve the name Ezequiel Melendez (full_name) ?	3	1	1	0	2	1	0
3-95743	injuring	city		month	How many people were injured in 11/2015 (month) in ('Connecticut', 'Windham') (city) ?	1	1	1	0	0	1	0
3-107521	injuring	city	first		How many people were injured in ('Florida', 'Orlando') (city) that involve the name Victor (first) ?	1	0	0	0	1	1	0
3-93569	injuring	state		day	How many people were injured in 12/08/2016 (day) in ('Texas',) (state) ?	5	5	4	1	1	4	7
3-85963	killing		first	year	How many people were killed in 2013 (year) that involve the name Demetrius (first) ?	3	3	3	0	0	1	3
3-74829	killing	city		year	How many people were killed in 2016 (year) in ('Colorado', 'Denver') (city) ?	7	7	5	2	2	4	9
3-104018	injuring		last	year	How many people were injured in 2016 (year) that involve the name Robinson (last) ?	3	9	2	7	1	1	5
3-81119	killing		full_name	year	How many people were killed in 2016 (year) that involve the name Jordan Dumas (full_name) ?	2	2	2	0	0	0	0
3-84623	killing		full_name	month	How many people were killed in 05/2014 (month) that involve the name Uriah Rezen (full_name) ?	1	0	0	0	1	0	0
3-103168	injuring		full_name	month	How many people were injured in 12/2016 (month) that involve the name Jarrett Thigpen (full_name) ?	1	0	0	0	1	0	0
3-104015	injuring		last	year	How many people were injured in 2016 (year) that involve the name Davis (last) ?	9	26	6	20	3	2	51
3-85955	killing		first	year	How many people were killed in 2016 (year) that involve the name Sean (first) ?	6	6	2	4	4	1	8
3-91390	killing	city	first		How many people were killed in ('Texas', 'San Benito') (city) that involve the name Jonathan (first) ?	1	0	0	0	1	0	0
3-79284	killing		first	month	How many people were killed in 10/2016 (month) that involve the name Edwin (first) ?	1	1	1	0	0	1	2
3-93574	injuring	state		day	How many people were injured in 10/05/2014 (day) in ('California',) (state) ?	1	2	1	1	0	6	6
3-94404	injuring	state		day	How many people were injured in 23/12/2016 (day) in ('Alabama',) (state) ?	1	0	0	0	1	3	0
3-89055	killing	city	last		How many people were killed in ('Arkansas', 'Little Rock') (city) that involve the name Brevard (last) ?	3	0	0	0	3	0	0
3-93555	injuring	state		day	How many people were injured in 04/10/2016 (day) in ('Virginia',) (state) ?	1	0	0	0	1	1	0
3-93554	injuring	state		day	How many people were injured in 29/08/2016 (day) in ('Virginia',) (state) ?	2	0	0	0	2	1	0
3-93559	injuring	state		day	How many people were injured in 08/06/2016 (day) in ('District of Columbia',) (state) ?	1	0	0	0	1	4	0
3-108403	injuring	state	last		How many people were injured in ('Illinois',) (state) that involve the name Brown (last) ?	7	2	2	0	5	0	5
3-81572	killing		full_name	year	How many people were killed in 2014 (year) that involve the name Kyle Carney (full_name) ?	2	1	1	0	1	0	0
3-82421	killing		last	year	How many people were killed in 2016 (year) that involve the name Price (last) ?	4	3	2	1	2	1	2
3-110719	injuring	state	full_name		How many people were injured in ('Georgia',) (state) that involve the name Kishonna Maxwell (full_name) ?	1	0	0	0	1	1	0
3-106228	injuring		first	day	How many people were injured in 05/09/2015 (day) that involve the name Geovany (first) ?	2	2	2	0	0	0	3
3-85921	killing		first	year	How many people were killed in 2016 (year) that involve the name Keagan (first) ?	3	2	2	0	1	2	1
3-104047	injuring		last	year	How many people were injured in 2013 (year) that involve the name Fain (last) ?	2	1	1	0	1	0	1
3-106226	injuring		first	day	How many people were injured in 19/06/2016 (day) that involve the name Devon (first) ?	2	1	1	0	1	1	0
3-83744	killing		full_name	month	How many people were killed in 11/2016 (month) that involve the name Kevin Douglas (full_name) ?	3	0	0	0	3	0	0
3-94891	injuring	city		year	How many people were injured in 2016 (year) in ('Wisconsin', 'Milwaukee') (city) ?	7	11	6	5	1	11	10
3-95740	injuring	city		month	How many people were injured in 12/2015 (month) in ('Louisiana', 'New Orleans') (city) ?	2	2	2	0	0	7	5
3-103180	injuring		full_name	month	How many people were injured in 07/2015 (month) that involve the name Amari Brown (full_name) ?	2	1	1	0	1	0	7
3-74805	killing	city		year	How many people were killed in 2015 (year) in ('California', 'Stockton') (city) ?	4	0	0	0	4	5	0
3-90034	killing	city	full_name		How many people were killed in ('Florida', 'Apopka') (city) that involve the name Quashun Massey (full_name) ?	2	0	0	0	2	0	0
3-91365	killing	city	first		How many people were killed in ('Indiana', 'Kokomo') (city) that involve the name LeMarcus (first) ?	1	1	1	0	0	1	1
3-95727	injuring	city		month	How many people were injured in 10/2016 (month) in ('Louisiana', 'Shreveport') (city) ?	3	4	3	1	0	5	6
3-108873	injuring	state	last		How many people were injured in ('Florida',) (state) that involve the name Payne (last) ?	4	1	1	0	3	2	4
3-95723	injuring	city		month	How many people were injured in 12/2014 (month) in ('Florida', 'Tampa') (city) ?	1	0	0	0	1	5	0
3-94878	injuring	city		year	How many people were injured in 2016 (year) in ('Alabama', 'Ozark') (city) ?	1	0	0	0	1	4	0
3-81100	killing		full_name	year	How many people were killed in 2016 (year) that involve the name Martaouse Holloway (full_name) ?	2	1	1	0	1	0	2
3-74807	killing	city		year	How many people were killed in 2015 (year) in ('New Jersey', 'Newark') (city) ?	3	1	1	0	2	2	2
3-83758	killing		full_name	month	How many people were killed in 08/2015 (month) that involve the name Joseph Horn (full_name) ?	3	3	3	0	0	1	2
3-84600	killing		full_name	month	How many people were killed in 01/2016 (month) that involve the name Jamyha Luss (full_name) ?	3	0	0	0	3	1	0
3-106215	injuring		first	day	How many people were injured in 07/03/2013 (day) that involve the name Joshua (first) ?	1	0	0	0	1	0	0
3-106214	injuring		first	day	How many people were injured in 21/08/2015 (day) that involve the name Dale (first) ?	4	2	2	0	2	1	5
3-94880	injuring	city		year	How many people were injured in 2014 (year) in ('Mississippi', 'Starkville') (city) ?	1	0	0	0	1	5	0
3-93553	injuring	state		day	How many people were injured in 01/06/2014 (day) in ('Illinois',) (state) ?	2	0	0	0	2	5	0
3-94400	injuring	state		day	How many people were injured in 26/01/2015 (day) in ('California',) (state) ?	1	1	1	0	0	3	0
3-94884	injuring	city		year	How many people were injured in 2015 (year) in ('Texas', 'Dallas') (city) ?	5	2	2	0	3	7	1
3-91372	killing	city	first		How many people were killed in ('Michigan', 'Detroit') (city) that involve the name Lise (first) ?	4	1	1	0	3	0	0
3-111431	job_firing		full_name	month	How many people were fired in 10/2013 (month) that involve the name Lauri Parks (full_name) ?	2	0	0	0	2	1	0
3-94503	injuring	city		year	How many people were injured in 2013 (year) in ('Nevada', 'Las Vegas') (city) ?	1	2	1	1	0	4	7
3-95835	injuring	city		month	How many people were injured in 07/2015 (month) in ('Indiana', 'Indianapolis') (city) ?	1	1	1	0	0	3	3
3-94502	injuring	city		year	How many people were injured in 2013 (year) in ('California', 'Madera') (city) ?	1	0	0	0	1	4	0
3-94986	injuring	city		year	How many people were injured in 2015 (year) in ('West Virginia', 'White Sulphur Springs') (city) ?	1	0	0	0	1	1	0
3-94501	injuring	city		year	How many people were injured in 2015 (year) in ('Georgia', 'Atlanta') (city) ?	5	8	4	4	1	10	21
3-93659	injuring	state		day	How many people were injured in 22/06/2015 (day) in ('Pennsylvania',) (state) ?	1	0	0	0	1	7	0
3-95832	injuring	city		month	How many people were injured in 08/2015 (month) in ('North Carolina', 'Durham') (city) ?	1	0	0	0	1	8	0
3-95839	injuring	city		month	How many people were injured in 07/2016 (month) in ('Missouri', 'Kansas City') (city) ?	1	0	0	0	1	1	0
3-100778	injuring		first	year	How many people were injured in 2015 (year) that involve the name Daniel (first) ?	2	5	1	4	1	0	2
3-103805	injuring		last	year	How many people were injured in 2015 (year) that involve the name Richardson (last) ?	1	2	1	1	0	0	3
3-100784	injuring		first	year	How many people were injured in 2016 (year) that involve the name Dominique (first) ?	7	4	3	1	4	1	4
3-81669	killing		full_name	year	How many people were killed in 2016 (year) that involve the name Coleton Weatherford (full_name) ?	2	2	2	0	0	0	0
3-100780	injuring		first	year	How many people were injured in 2016 (year) that involve the name La'Shannon (first) ?	1	0	0	0	1	0	0
3-95841	injuring	city		month	How many people were injured in 01/2015 (month) in ('Florida', 'Lakeland') (city) ?	1	0	0	0	1	3	0
3-82519	killing		last	year	How many people were killed in 2016 (year) that involve the name Edwards (last) ?	4	8	4	4	0	1	14
3-83849	killing		full_name	month	How many people were killed in 07/2015 (month) that involve the name Cheyenne Jessie (full_name) ?	2	0	0	0	2	0	0
3-77176	killing	state		day	How many people were killed in 15/05/2015 (day) in ('Arkansas',) (state) ?	1	0	0	0	1	1	0
3-93644	injuring	state		day	How many people were injured in 18/08/2013 (day) in ('Illinois',) (state) ?	1	0	0	0	1	3	0
3-94975	injuring	city		year	How many people were injured in 2015 (year) in ('New York', 'Lake Placid') (city) ?	3	0	0	0	3	1	0
3-95825	injuring	city		month	How many people were injured in 04/2016 (month) in ('California', 'Fresno') (city) ?	1	0	0	0	1	1	0
3-77180	killing	city		month	How many people were killed in 01/2015 (month) in ('Georgia', 'Fort Valley') (city) ?	1	1	1	0	0	1	0
3-82526	killing		last	year	How many people were killed in 2015 (year) that involve the name Edwards (last) ?	8	2	2	0	6	2	5
3-84706	killing		full_name	month	How many people were killed in 10/2014 (month) that involve the name Austin Hedrick (full_name) ?	2	2	2	0	0	1	2
3-80343	killing		first	day	How many people were killed in 19/11/2015 (day) that involve the name Shawn (first) ?	1	1	1	0	0	0	0
3-102950	injuring		full_name	month	How many people were injured in 10/2016 (month) that involve the name Diego Reid (full_name) ?	3	1	1	0	2	0	0
3-110569	injuring	state	full_name		How many people were injured in ('Missouri',) (state) that involve the name Brian Jermon (full_name) ?	2	0	0	0	2	0	0
3-94982	injuring	city		year	How many people were injured in 2014 (year) in ('California', 'Sacramento') (city) ?	4	2	2	0	2	20	6
3-77187	killing	city		month	How many people were killed in 11/2015 (month) in ('Texas', 'Houston') (city) ?	2	2	2	0	0	2	2
3-111418	job_firing		full_name	month	How many people were fired in 06/2013 (month) that involve the name David Mueller (full_name) ?	3	0	0	0	3	1	0
3-77188	killing	city		month	How many people were killed in 11/2015 (month) in ('Ohio', 'Dayton') (city) ?	2	1	1	0	1	1	1
3-111453	job_firing		first	year	How many people were fired in 2015 (year) that involve the name Deanne (first) ?	1	0	0	0	1	1	0
3-94965	injuring	city		year	How many people were injured in 2016 (year) in ('Utah', 'Logan') (city) ?	1	0	0	0	1	1	0
3-95815	injuring	city		month	How many people were injured in 05/2016 (month) in ('Maryland', 'Baltimore') (city) ?	3	0	0	0	3	6	0
3-94962	injuring	city		year	How many people were injured in 2016 (year) in ('California', 'San Diego') (city) ?	1	3	1	2	0	2	3
3-94968	injuring	city		year	How many people were injured in 2014 (year) in ('Ohio', 'Springfield') (city) ?	1	0	0	0	1	3	0
3-109139	injuring	city	full_name		How many people were injured in ('New York', 'Medford') (city) that involve the name Taleik Bristel (full_name) ?	2	0	0	0	2	0	0
3-111454	job_firing		first	year	How many people were fired in 2013 (year) that involve the name Stephanie (first) ?	2	0	0	0	2	1	0
3-98091	injuring	state		month	How many people were injured in 06/2015 (month) in ('Florida',) (state) ?	2	2	2	0	0	8	4
3-101654	injuring		first	month	How many people were injured in 10/2016 (month) that involve the name Jeffrey (first) ?	2	2	2	0	0	0	6
3-103833	injuring		last	year	How many people were injured in 2016 (year) that involve the name Caston (last) ?	5	2	2	0	3	0	2
3-83824	killing		full_name	month	How many people were killed in 11/2015 (month) that involve the name Zion Willis (full_name) ?	2	2	2	0	0	1	2
3-102987	injuring		full_name	month	How many people were injured in 10/2013 (month) that involve the name Steven Wilson (full_name) ?	1	1	1	0	0	1	0
3-80310	killing		first	day	How many people were killed in 22/04/2016 (day) that involve the name Jacob (first) ?	1	1	1	0	0	0	0
3-98098	injuring	state		month	How many people were injured in 07/2016 (month) in ('Louisiana',) (state) ?	5	5	2	3	3	7	11
3-82972	killing		last	day	How many people were killed in 13/09/2015 (day) that involve the name Burns (last) ?	3	1	1	0	2	1	1
3-79338	killing		first	month	How many people were killed in 06/2016 (month) that involve the name Darrell (first) ?	1	1	1	0	0	0	2
3-102983	injuring		full_name	month	How many people were injured in 05/2016 (month) that involve the name Alexis Mungin (full_name) ?	1	1	1	0	0	0	3
3-98095	injuring	state		month	How many people were injured in 11/2016 (month) in ('New Jersey',) (state) ?	6	7	4	3	2	5	5
3-98094	injuring	state		month	How many people were injured in 08/2016 (month) in ('Texas',) (state) ?	10	14	6	8	4	13	10
3-110116	injuring	city	last		How many people were injured in ('North Dakota', 'Bismarck') (city) that involve the name Simmons (last) ?	2	0	0	0	2	0	0
3-77150	killing	state		day	How many people were killed in 07/09/2015 (day) in ('Indiana',) (state) ?	1	0	0	0	1	2	0
3-79330	killing		first	month	How many people were killed in 11/2016 (month) that involve the name Jacob (first) ?	3	3	3	0	0	1	1
3-111442	job_firing		first	year	How many people were fired in 2015 (year) that involve the name Ty (first) ?	1	0	0	0	1	1	0
3-93623	injuring	state		day	How many people were injured in 26/01/2013 (day) in ('District of Columbia',) (state) ?	3	0	0	0	3	5	0
3-95803	injuring	city		month	How many people were injured in 09/2015 (month) in ('Oklahoma', 'Tulsa') (city) ?	1	1	1	0	0	6	0
3-94952	injuring	city		year	How many people were injured in 2016 (year) in ('Texas', 'Lubbock') (city) ?	3	3	3	0	0	9	6
3-109124	injuring	city	full_name		How many people were injured in ('Georgia', 'Atlanta') (city) that involve the name Selemon Belai (full_name) ?	2	2	2	0	0	0	4
3-93620	injuring	state		day	How many people were injured in 12/06/2015 (day) in ('Nevada',) (state) ?	2	2	2	0	0	1	0
3-95805	injuring	city		month	How many people were injured in 04/2016 (month) in ('Michigan', 'Gladwin') (city) ?	2	0	0	0	2	1	0
3-109125	injuring	city	full_name		How many people were injured in ('Florida', 'Miami') (city) that involve the name Travonte Berry (full_name) ?	2	1	1	0	1	0	1
3-93627	injuring	state		day	How many people were injured in 07/12/2013 (day) in ('Delaware',) (state) ?	2	0	0	0	2	4	0
3-111445	job_firing		first	year	How many people were fired in 2009 (year) that involve the name Francisca (first) ?	3	0	0	0	3	1	0
3-93626	injuring	state		day	How many people were injured in 04/06/2014 (day) in ('Illinois',) (state) ?	1	1	1	0	0	3	2
3-111444	job_firing		first	year	How many people were fired in 2015 (year) that involve the name Travis (first) ?	1	0	0	0	1	1	0
3-100309	injuring		first	year	How many people were injured in 2013 (year) that involve the name Raymond (first) ?	2	0	0	0	2	1	0
3-83840	killing		full_name	month	How many people were killed in 11/2016 (month) that involve the name Jesse Dobbs (full_name) ?	3	3	3	0	0	0	2
3-103818	injuring		last	year	How many people were injured in 2013 (year) that involve the name Smith (last) ?	5	10	5	5	0	2	27
3-95806	injuring	city		month	How many people were injured in 09/2013 (month) in ('Florida', 'Kissimmee') (city) ?	1	0	0	0	1	5	0
3-95807	injuring	city		month	How many people were injured in 05/2016 (month) in ('Florida', 'Miami') (city) ?	2	1	1	0	1	3	3
3-103823	injuring		last	year	How many people were injured in 2016 (year) that involve the name Marrero (last) ?	10	5	3	2	7	1	6
3-98088	injuring	state		month	How many people were injured in 11/2016 (month) in ('California',) (state) ?	9	10	3	7	6	20	19
3-98082	injuring	state		month	How many people were injured in 06/2016 (month) in ('Delaware',) (state) ?	3	4	1	3	2	5	3
3-83833	killing		full_name	month	How many people were killed in 05/2016 (month) that involve the name Diata Crockett (full_name) ?	1	1	1	0	0	0	0
3-101640	injuring		first	month	How many people were injured in 09/2016 (month) that involve the name Anthony (first) ?	5	3	2	1	3	1	6
3-77161	killing	state		day	How many people were killed in 04/01/2016 (day) in ('Colorado',) (state) ?	1	0	0	0	1	1	0
3-93630	injuring	state		day	How many people were injured in 26/11/2016 (day) in ('Nevada',) (state) ?	1	1	1	0	0	1	0
3-109120	injuring	city	full_name		How many people were injured in ('Illinois', 'Chicago') (city) that involve the name Marissa Boyd-Stangley (full_name) ?	1	0	0	0	1	0	0
3-93612	injuring	state		day	How many people were injured in 05/11/2016 (day) in ('North Carolina',) (state) ?	1	1	1	0	0	3	3
3-94943	injuring	city		year	How many people were injured in 2016 (year) in ('Florida', 'Orlando') (city) ?	7	0	0	0	7	11	0
3-93611	injuring	state		day	How many people were injured in 11/12/2016 (day) in ('Iowa',) (state) ?	1	0	0	0	1	1	0
3-89110	killing	city	last		How many people were killed in ('Kentucky', 'Greensburg') (city) that involve the name Moore (last) ?	1	0	0	0	1	2	0
3-108222	injuring	state	first		How many people were injured in ('Texas',) (state) that involve the name Adrian (first) ?	7	3	3	0	4	0	4
3-94940	injuring	city		year	How many people were injured in 2015 (year) in ('Florida', 'Lakeland') (city) ?	2	0	0	0	2	4	0
3-100738	injuring		first	year	How many people were injured in 2016 (year) that involve the name Ricardo (first) ?	2	1	1	0	1	0	2
3-93619	injuring	state		day	How many people were injured in 19/02/2013 (day) in ('California',) (state) ?	5	0	0	0	5	3	0
3-89118	killing	city	last		How many people were killed in ('Illinois', 'Chicago') (city) that involve the name Brown (last) ?	5	1	1	0	4	1	3
3-89597	killing	city	full_name		How many people were killed in ('Pennsylvania', 'Erie') (city) that involve the name Keshawn McLaurin (full_name) ?	5	0	0	0	5	0	0
3-98072	injuring	state		month	How many people were injured in 10/2015 (month) in ('Kentucky',) (state) ?	3	3	3	0	0	2	0
3-79791	killing		first	day	How many people were killed in 13/12/2016 (day) that involve the name Melanie (first) ?	2	0	0	0	2	1	0
3-105196	injuring		full_name	day	How many people were injured in 03/12/2016 (day) that involve the name Xyahir Davis (full_name) ?	3	2	2	0	1	0	0
3-106042	injuring		last	day	How many people were injured in 30/07/2015 (day) that involve the name Thomas (last) ?	1	1	1	0	0	1	3
3-90593	killing	state	full_name		How many people were killed in ('Pennsylvania',) (state) that involve the name Maurice Phillips (full_name) ?	4	3	2	1	2	0	0
3-109541	injuring	city	full_name		How many people were injured in ('North Carolina', 'Charlotte') (city) that involve the name Heather Davenport (full_name) ?	1	0	0	0	1	0	0
3-92757	killing	state	last		How many people were killed in ('North Carolina',) (state) that involve the name Robinson (last) ?	2	1	1	0	1	0	1
3-93605	injuring	state		day	How many people were injured in 05/11/2016 (day) in ('Illinois',) (state) ?	1	0	0	0	1	5	0
3-94936	injuring	city		year	How many people were injured in 2016 (year) in ('California', 'Lodi') (city) ?	2	0	0	0	2	1	0
3-108215	injuring	state	first		How many people were injured in ('Florida',) (state) that involve the name Justin (first) ?	2	1	1	0	1	0	3
3-91425	killing	city	first		How many people were killed in ('Michigan', 'Detroit') (city) that involve the name Demetrius (first) ?	3	1	1	0	2	0	4
3-94933	injuring	city		year	How many people were injured in 2015 (year) in ('New Jersey', 'Newark') (city) ?	4	1	1	0	3	10	3
3-94939	injuring	city		year	How many people were injured in 2015 (year) in ('Ohio', 'Cleveland') (city) ?	4	1	0	1	4	4	0
3-89129	killing	city	last		How many people were killed in ('Illinois', 'Chicago') (city) that involve the name Parker (last) ?	1	0	0	0	1	1	0
3-108219	injuring	state	first		How many people were injured in ('Florida',) (state) that involve the name Kevin (first) ?	4	5	3	2	1	0	4
3-102902	injuring		full_name	month	How many people were injured in 07/2016 (month) that involve the name Erica Rodriguez (full_name) ?	3	3	3	0	0	0	2
3-76299	killing	state		month	How many people were killed in 11/2016 (month) in ('Pennsylvania',) (state) ?	8	7	5	2	3	7	7
3-98063	injuring	state		month	How many people were injured in 08/2016 (month) in ('Washington',) (state) ?	4	4	4	0	0	6	6
3-98066	injuring	state		month	How many people were injured in 06/2014 (month) in ('Georgia',) (state) ?	2	2	2	0	0	4	4
3-99396	injuring	city		day	How many people were injured in 08/09/2015 (day) in (None, 'Karachi') (city) ?	1	1	1	0	0	1	0
3-99398	injuring	city		day	How many people were injured in 30/10/2016 (day) in ('Texas', 'San Antonio') (city) ?	4	4	4	0	0	5	6
3-98069	injuring	state		month	How many people were injured in 05/2015 (month) in ('Missouri',) (state) ?	2	2	2	0	0	5	0
3-87396	killing		last	month	How many people were killed in 11/2016 (month) that involve the name Wilson (last) ?	5	7	4	3	1	3	9
3-92740	killing	state	last		How many people were killed in ('California',) (state) that involve the name Daniels (last) ?	1	0	0	0	1	0	0
3-94927	injuring	city		year	How many people were injured in 2016 (year) in ('Louisiana', 'New Orleans') (city) ?	15	15	8	7	7	17	54
3-87399	killing		last	month	How many people were killed in 11/2016 (month) that involve the name Mushrush (last) ?	2	2	2	0	0	0	0
3-76265	killing	state		month	How many people were killed in 09/2016 (month) in ('Arkansas',) (state) ?	4	4	3	1	1	2	2
3-80752	killing		full_name	year	How many people were killed in 2015 (year) that involve the name Anthony Jackson (full_name) ?	3	1	1	0	2	0	3
3-110550	injuring	state	full_name		How many people were injured in ('Massachusetts',) (state) that involve the name Rodolfo Mercado (full_name) ?	2	0	0	0	2	0	0
3-88250	killing	state	first		How many people were killed in ('Illinois',) (state) that involve the name Ketrell (first) ?	1	0	0	0	1	1	0
3-94914	injuring	city		year	How many people were injured in 2015 (year) in ('Indiana', 'Indianapolis') (city) ?	9	3	3	0	6	10	7
3-90555	killing	state	full_name		How many people were killed in ('Virginia',) (state) that involve the name Jordan Stewart (full_name) ?	2	1	1	0	1	1	0
3-110552	injuring	state	full_name		How many people were injured in ('Oregon',) (state) that involve the name Refugio Modesto-DeLaCruz (full_name) ?	3	1	1	0	2	1	0
3-94918	injuring	city		year	How many people were injured in 2015 (year) in ('Washington', 'Seattle') (city) ?	4	3	1	2	3	4	0
3-100749	injuring		first	year	How many people were injured in 2013 (year) that involve the name Shakir (first) ?	2	2	2	0	0	0	8
3-89107	killing	city	last		How many people were killed in ('Michigan', 'Detroit') (city) that involve the name Williams (last) ?	4	5	2	3	2	3	15
3-89104	killing	city	last		How many people were killed in ('Tennessee', 'Chattanooga') (city) that involve the name McCane (last) ?	2	0	0	0	2	0	0
3-89588	killing	city	full_name		How many people were killed in ('Michigan', 'Detroit') (city) that involve the name Demetrius Herndon (full_name) ?	1	0	0	0	1	0	0
3-94919	injuring	city		year	How many people were injured in 2015 (year) in ('California', 'Oakland') (city) ?	1	0	0	0	1	2	0
3-74097	killing	state		year	How many people were killed in 2016 (year) in ('California',) (state) ?	55	48	41	7	14	39	36
3-76277	killing	state		month	How many people were killed in 03/2016 (month) in ('Hawaii',) (state) ?	2	2	2	0	0	1	0
3-101600	injuring		first	month	How many people were injured in 10/2016 (month) that involve the name Lia (first) ?	1	1	1	0	0	1	0
3-76279	killing	state		month	How many people were killed in 08/2016 (month) in ('Georgia',) (state) ?	3	4	2	2	1	3	2
3-76272	killing	state		month	How many people were killed in 11/2016 (month) in ('Arkansas',) (state) ?	9	4	4	0	5	4	1
3-99377	injuring	city		day	How many people were injured in 23/11/2014 (day) in ('Colorado', 'Denver') (city) ?	2	2	2	0	0	4	7
3-99376	injuring	city		day	How many people were injured in 01/07/2015 (day) in ('Florida', 'Plant City') (city) ?	1	0	0	0	1	1	0
3-74099	killing	state		year	How many people were killed in 2015 (year) in ('Florida',) (state) ?	21	19	14	5	7	17	27
3-91877	killing	city	first		How many people were killed in ('Florida', 'Miami Gardens') (city) that involve the name Janet (first) ?	1	1	1	0	0	1	2
3-94901	injuring	city		year	How many people were injured in 2016 (year) in ('Delaware', 'Wilmington') (city) ?	3	0	0	0	3	5	0
3-94907	injuring	city		year	How many people were injured in 2016 (year) in ('California', 'Fresno') (city) ?	8	4	4	0	4	18	10
3-111030	injuring	state	full_name		How many people were injured in ('Alabama',) (state) that involve the name Reginald Williams (full_name) ?	1	0	0	0	1	0	0
3-89554	killing	city	full_name		How many people were killed in ('Illinois', 'Chicago') (city) that involve the name Tyrone Spikes (full_name) ?	3	1	1	0	2	1	3
3-110182	injuring	city	last		How many people were injured in ('Minnesota', 'Felton') (city) that involve the name Rocha (last) ?	2	0	0	0	2	0	0
3-94908	injuring	city		year	How many people were injured in 2016 (year) in ('California', 'Sacramento') (city) ?	13	4	4	0	9	18	10
3-99362	injuring	city		day	How many people were injured in 21/12/2014 (day) in ('Illinois', 'Calumet City') (city) ?	2	2	2	0	0	8	8
3-104747	injuring		full_name	year	How many people were injured in 2014 (year) that involve the name Porfirio Hernandez (full_name) ?	1	1	1	0	0	0	6
3-99364	injuring	city		day	How many people were injured in 26/09/2016 (day) in ('Texas', 'Houston') (city) ?	6	5	4	1	2	6	17
3-101237	injuring		first	month	How many people were injured in 01/2016 (month) that involve the name Colton (first) ?	1	0	0	0	1	0	0
3-99363	injuring	city		day	How many people were injured in 25/04/2016 (day) in ('Indiana', 'Georgetown') (city) ?	1	0	0	0	1	1	0
3-100385	injuring		first	year	How many people were injured in 2013 (year) that involve the name Demetrius (first) ?	6	3	3	0	3	0	9
3-102562	injuring		full_name	month	How many people were injured in 05/2013 (month) that involve the name Illya Benson (full_name) ?	2	1	1	0	1	0	2
3-103893	injuring		last	year	How many people were injured in 2016 (year) that involve the name Barkley (last) ?	2	1	1	0	1	0	0
3-2	injuring	state		year	How many people were injured in 2006 (year) in ('Oregon',) (state) ?	0	0	0	0	0	0	0
3-3	killing	city		year	How many people were killed in 2013 (year) in ('Ohio', 'Amelia') (city) ?	0	0	0	0	0	0	0
3-102561	injuring		full_name	month	How many people were injured in 03/2015 (month) that involve the name Anthony Jennings (full_name) ?	1	1	1	0	0	0	0
3-4	injuring	city		year	How many people were injured in 2016 (year) in ('New Mexico', 'Rio Rancho') (city) ?	0	0	0	0	0	0	0
3-5	injuring	city		year	How many people were injured in 2013 (year) in ('Virginia', 'Charlotte (county)') (city) ?	0	0	0	0	0	0	0
3-6	injuring	city		year	How many people were injured in 2008 (year) in ('Colorado', 'Denver') (city) ?	0	0	0	0	0	0	0
3-77570	killing	city		month	How many people were killed in 03/2015 (month) in ('New Jersey', 'Newark') (city) ?	1	0	0	0	1	1	0
3-99366	injuring	city		day	How many people were injured in 27/04/2016 (day) in ('Louisiana', 'Baton Rouge') (city) ?	1	0	0	0	1	2	0
3-7	injuring	city		year	How many people were injured in 2016 (year) in ('Mississippi', 'Starkville') (city) ?	0	0	0	0	0	0	0
3-75398	killing	city		day	How many people were killed in 29/10/2014 (day) in ('Florida', 'Belleview') (city) ?	1	0	0	0	1	1	0
3-76240	killing	state		month	How many people were killed in 10/2016 (month) in ('Ohio',) (state) ?	6	6	4	2	2	5	7
3-8	injuring	city		year	How many people were injured in 2007 (year) in ('Virginia', 'Hampton') (city) ?	0	0	0	0	0	0	0
3-77573	killing	city		month	How many people were killed in 02/2015 (month) in ('Texas', 'Houston') (city) ?	3	1	1	0	2	4	0
3-9	killing	city		year	How many people were killed in 2016 (year) in ('Alabama', 'Tuscaloosa') (city) ?	0	0	0	0	0	0	0
3-111022	injuring	state	full_name		How many people were injured in ('Georgia',) (state) that involve the name Tyderris Cash (full_name) ?	2	1	1	0	1	0	0
3-110172	injuring	city	last		How many people were injured in ('Maryland', 'District Heights (Forestville)') (city) that involve the name Woods (last) ?	1	1	1	0	0	0	4
3-100377	injuring		first	year	How many people were injured in 2015 (year) that involve the name Christopher (first) ?	5	11	2	9	3	0	15
3-103402	injuring		last	year	How many people were injured in 2013 (year) that involve the name Brown (last) ?	5	6	5	1	0	1	12
3-76256	killing	state		month	How many people were killed in 10/2016 (month) in ('New York',) (state) ?	6	2	2	0	4	3	2
3-101221	injuring		first	month	How many people were injured in 08/2016 (month) that involve the name Johnathan (first) ?	1	1	1	0	0	0	0
3-76258	killing	state		month	How many people were killed in 10/2016 (month) in ('Florida',) (state) ?	3	3	3	0	0	4	3
3-77107	killing	state		day	How many people were killed in 17/04/2016 (day) in ('Pennsylvania',) (state) ?	3	3	1	2	2	3	0
3-103880	injuring		last	year	How many people were injured in 2015 (year) that involve the name Murphy (last) ?	5	4	4	0	1	0	13
3-100372	injuring		first	year	How many people were injured in 2016 (year) that involve the name Elijah (first) ?	8	9	5	4	3	0	12
3-76250	killing	state		month	How many people were killed in 12/2016 (month) in ('New York',) (state) ?	6	0	0	0	6	2	0
3-90524	killing	state	full_name		How many people were killed in ('Texas',) (state) that involve the name Gary Shelton (full_name) ?	2	0	0	0	2	0	0
3-92701	killing	state	last		How many people were killed in ('Ohio',) (state) that involve the name Rudd (last) ?	1	1	1	0	0	1	2
3-76219	killing	state		month	How many people were killed in 07/2016 (month) in ('Utah',) (state) ?	3	3	3	0	0	2	1
3-86027	killing		first	year	How many people were killed in 2013 (year) that involve the name Michael (first) ?	4	5	4	1	0	2	4
3-88203	killing	state	first		How many people were killed in ('Rhode Island',) (state) that involve the name Branden (first) ?	2	1	1	0	1	0	0
3-111050	injuring	state	full_name		How many people were injured in ('Indiana',) (state) that involve the name Jonte Johnson (full_name) ?	3	1	1	0	2	0	4
3-103438	injuring		last	year	How many people were injured in 2015 (year) that involve the name Davis (last) ?	4	8	3	5	1	0	6
3-75371	killing	city		day	How many people were killed in 30/01/2016 (day) in ('Georgia', 'Atlanta') (city) ?	2	0	0	0	2	1	0
3-98494	injuring	state		month	How many people were injured in 06/2015 (month) in ('Texas',) (state) ?	4	5	2	3	2	4	3
3-102585	injuring		full_name	month	How many people were injured in 12/2013 (month) that involve the name Brandon Varlow (full_name) ?	1	1	1	0	0	0	4
3-103434	injuring		last	year	How many people were injured in 2013 (year) that involve the name Wright (last) ?	3	3	2	1	1	3	1
3-89529	killing	city	full_name		How many people were killed in ('Georgia', 'Augusta') (city) that involve the name Rasheem Scriven (full_name) ?	2	1	1	0	1	1	2
3-77559	killing	city		month	How many people were killed in 06/2014 (month) in ('Florida', 'Miami') (city) ?	3	3	3	0	0	3	5
3-99347	injuring	city		day	How many people were injured in 01/05/2016 (day) in ('Vermont', 'Moretown') (city) ?	2	0	0	0	2	1	0
3-98497	injuring	state		month	How many people were injured in 07/2016 (month) in ('Illinois',) (state) ?	4	1	1	0	3	7	2
3-99344	injuring	city		day	How many people were injured in 15/07/2015 (day) in ('Maryland', 'Baltimore') (city) ?	1	0	0	0	1	3	0
3-99343	injuring	city		day	How many people were injured in 23/02/2016 (day) in ('Florida', 'Sanford') (city) ?	2	0	0	0	2	1	0
3-99346	injuring	city		day	How many people were injured in 25/10/2015 (day) in ('Florida', 'Orlando') (city) ?	1	0	0	0	1	2	0
3-78881	killing		first	month	How many people were killed in 12/2015 (month) that involve the name Michael (first) ?	3	4	1	3	2	1	3
3-88691	killing	state	first		How many people were killed in ('Louisiana',) (state) that involve the name Gerald (first) ?	1	4	1	3	0	1	1
3-111049	injuring	state	full_name		How many people were injured in ('California',) (state) that involve the name Kenneth Mills (full_name) ?	2	1	1	0	1	0	4
3-79738	killing		first	month	How many people were killed in 03/2014 (month) that involve the name Tristan (first) ?	2	1	1	0	1	0	0
3-88215	killing	state	first		How many people were killed in ('Texas',) (state) that involve the name William (first) ?	4	6	3	3	1	1	2
3-89546	killing	city	full_name		How many people were killed in ('District of Columbia', 'Washington') (city) that involve the name Breyona McMillian (full_name) ?	3	0	0	0	3	1	0
3-88214	killing	state	first		How many people were killed in ('California',) (state) that involve the name Kenneth (first) ?	3	2	1	1	2	1	0
3-106927	injuring	city	first		How many people were injured in ('Indiana', 'Indianapolis') (city) that involve the name Tristan (first) ?	2	0	0	0	2	0	0
3-89542	killing	city	full_name		How many people were killed in ('Arizona', 'Tucson') (city) that involve the name Daniel Wright (full_name) ?	1	1	1	0	0	1	0
3-99339	injuring	city		day	How many people were injured in 09/11/2013 (day) in ('Texas', 'Cypress') (city) ?	2	0	0	0	2	16	0
3-98485	injuring	state		month	How many people were injured in 05/2016 (month) in ('New Jersey',) (state) ?	2	1	1	0	1	11	0
3-98487	injuring	state		month	How many people were injured in 03/2016 (month) in ('California',) (state) ?	7	4	4	0	3	14	14
3-110141	injuring	city	last		How many people were injured in ('Texas', 'Austin') (city) that involve the name Moultrie (last) ?	9	5	5	0	4	0	11
3-109157	injuring	city	full_name		How many people were injured in ('Illinois', 'Chicago') (city) that involve the name Micquelyn Biles (full_name) ?	3	0	0	0	3	0	0
3-85158	killing		full_name	day	How many people were killed in 19/05/2016 (day) that involve the name Ackeem Davis (full_name) ?	4	4	4	0	0	1	3
3-79705	killing		first	month	How many people were killed in 11/2016 (month) that involve the name Marcus (first) ?	5	2	1	1	4	1	0
3-86005	killing		first	year	How many people were killed in 2016 (year) that involve the name Justice (first) ?	3	1	1	0	2	1	0
3-103849	injuring		last	year	How many people were injured in 2013 (year) that involve the name Morris (last) ?	1	1	1	0	0	0	2
3-79709	killing		first	month	How many people were killed in 04/2016 (month) that involve the name Constance (first) ?	1	1	1	0	0	1	0
3-86003	killing		first	year	How many people were killed in 2014 (year) that involve the name Galen (first) ?	2	1	1	0	1	0	0
3-90508	killing	state	full_name		How many people were killed in ('Pennsylvania',) (state) that involve the name Samir Price (full_name) ?	3	1	1	0	2	0	0
3-102523	injuring		full_name	month	How many people were injured in 06/2016 (month) that involve the name William Hampton (full_name) ?	1	1	1	0	0	0	2
3-103855	injuring		last	year	How many people were injured in 2014 (year) that involve the name Tiggs (last) ?	2	2	2	0	0	1	3
3-96292	injuring	city		month	How many people were injured in 02/2016 (month) in ('New Jersey', 'Paterson') (city) ?	2	1	1	0	1	1	0
3-98471	injuring	state		month	How many people were injured in 07/2014 (month) in ('Rhode Island',) (state) ?	1	1	1	0	0	5	5
3-102522	injuring		full_name	month	How many people were injured in 06/2016 (month) that involve the name Caleb Young (full_name) ?	2	0	0	0	2	1	0
3-76200	killing	state		month	How many people were killed in 03/2016 (month) in ('Texas',) (state) ?	4	7	4	3	0	4	6
3-98470	injuring	state		month	How many people were injured in 05/2013 (month) in ('California',) (state) ?	7	5	5	0	2	6	12
3-76201	killing	state		month	How many people were killed in 01/2016 (month) in ('Pennsylvania',) (state) ?	9	2	2	0	7	2	1
3-98473	injuring	state		month	How many people were injured in 08/2016 (month) in ('Virginia',) (state) ?	6	5	5	0	1	8	7
3-96291	injuring	city		month	How many people were injured in 08/2016 (month) in ('Connecticut', 'Bridgeport') (city) ?	6	2	2	0	4	13	0
3-98475	injuring	state		month	How many people were injured in 10/2016 (month) in ('Arizona',) (state) ?	2	1	1	0	1	3	0
3-98476	injuring	state		month	How many people were injured in 07/2015 (month) in ('Wisconsin',) (state) ?	1	1	1	0	0	1	0
3-87340	killing		last	month	How many people were killed in 10/2016 (month) that involve the name Morris (last) ?	1	1	1	0	0	0	0
3-85162	killing		full_name	day	How many people were killed in 10/05/2016 (day) that involve the name DaMarcia Clark (full_name) ?	1	0	0	0	1	0	0
3-99308	injuring	city		day	How many people were injured in 31/07/2016 (day) in ('Texas', 'Austin') (city) ?	9	3	3	0	6	4	4
3-111465	job_firing		full_name	year	How many people were fired in 2011 (year) that involve the name Justin Dobbs (full_name) ?	2	0	0	0	2	1	0
3-77539	killing	city		month	How many people were killed in 11/2015 (month) in ('Tennessee', 'Goodlettsville') (city) ?	3	2	2	0	1	1	0
3-86499	killing		first	year	How many people were killed in 2016 (year) that involve the name Shawn (first) ?	8	3	1	2	7	1	1
3-100327	injuring		first	year	How many people were injured in 2016 (year) that involve the name Jada (first) ?	2	1	1	0	1	0	0
3-86495	killing		first	year	How many people were killed in 2013 (year) that involve the name Jay (first) ?	1	1	1	0	0	0	2
3-86012	killing		first	year	How many people were killed in 2015 (year) that involve the name Ricky (first) ?	2	2	0	2	2	0	0
3-98460	injuring	state		month	How many people were injured in 03/2015 (month) in ('Kentucky',) (state) ?	4	5	2	3	2	2	3
3-100334	injuring		first	year	How many people were injured in 2016 (year) that involve the name Adrian (first) ?	3	3	2	1	1	0	5
3-99790	injuring	city		day	How many people were injured in 03/09/2016 (day) in ('Maryland', 'Baltimore') (city) ?	1	0	0	0	1	3	0
3-76217	killing	state		month	How many people were killed in 07/2016 (month) in ('Arizona',) (state) ?	2	2	2	0	0	3	2
3-99315	injuring	city		day	How many people were injured in 27/08/2016 (day) in ('Louisiana', 'New Orleans') (city) ?	1	1	1	0	0	2	0
3-111459	job_firing		first	year	How many people were fired in 2014 (year) that involve the name Perry (first) ?	1	0	0	0	1	1	0
3-96286	injuring	city		month	How many people were injured in 06/2016 (month) in ('Virginia', 'Norfolk') (city) ?	1	1	1	0	0	4	0
3-98463	injuring	state		month	How many people were injured in 07/2013 (month) in ('California',) (state) ?	3	2	2	0	1	7	4
3-99310	injuring	city		day	How many people were injured in 14/07/2015 (day) in ('Missouri', 'Saint Louis') (city) ?	1	0	0	0	1	4	0
3-96287	injuring	city		month	How many people were injured in 07/2015 (month) in ('Missouri', 'Saint Louis') (city) ?	2	0	0	0	2	6	0
3-99312	injuring	city		day	How many people were injured in 13/11/2016 (day) in ('Indiana', 'Indianapolis') (city) ?	4	1	1	0	3	2	5
3-109178	injuring	city	full_name		How many people were injured in ('New Mexico', 'Albuquerque') (city) that involve the name Jaquise Lewis (full_name) ?	4	2	2	0	2	0	7
3-110169	injuring	city	last		How many people were injured in ('Virginia', 'Norfolk') (city) that involve the name Barnes (last) ?	1	0	0	0	1	1	0
3-76658	killing	state		day	How many people were killed in 19/02/2013 (day) in ('California',) (state) ?	5	0	0	0	5	4	0
3-86468	killing		first	year	How many people were killed in 2016 (year) that involve the name Ja'Mare (first) ?	3	0	0	0	3	0	0
3-88647	killing	state	first		How many people were killed in ('Texas',) (state) that involve the name Willie (first) ?	3	3	3	0	0	1	5
3-104717	injuring		full_name	year	How many people were injured in 2016 (year) that involve the name Naome Innis (full_name) ?	1	0	0	0	1	0	0
3-87796	killing	state	first		How many people were killed in ('New Mexico',) (state) that involve the name Nehemiah (first) ?	6	3	3	0	3	0	4
3-101209	injuring		first	month	How many people were injured in 12/2016 (month) that involve the name Jacquelent (first) ?	1	1	1	0	0	0	2
3-103868	injuring		last	year	How many people were injured in 2016 (year) that involve the name Young (last) ?	3	8	1	7	2	1	13
3-94090	injuring	state		day	How many people were injured in 21/02/2016 (day) in ('Missouri',) (state) ?	3	1	1	0	2	3	3
3-76663	killing	state		day	How many people were killed in 17/09/2015 (day) in ('South Dakota',) (state) ?	2	1	1	0	1	6	6
3-76665	killing	state		day	How many people were killed in 24/10/2016 (day) in ('South Carolina',) (state) ?	1	0	0	0	1	1	0
3-94094	injuring	state		day	How many people were injured in 11/12/2016 (day) in ('New York',) (state) ?	2	0	0	0	2	4	0
3-101696	injuring		last	month	How many people were injured in 07/2015 (month) that involve the name Heard (last) ?	2	1	1	0	1	0	2
3-102542	injuring		full_name	month	How many people were injured in 10/2016 (month) that involve the name Jabree Hines (full_name) ?	2	2	2	0	0	0	0
3-94092	injuring	state		day	How many people were injured in 22/06/2016 (day) in ('Illinois',) (state) ?	1	0	0	0	1	4	0
3-96278	injuring	city		month	How many people were injured in 06/2016 (month) in ('Connecticut', 'Hartford') (city) ?	2	1	1	0	1	5	0
3-98457	injuring	state		month	How many people were injured in 05/2016 (month) in ('Florida',) (state) ?	4	4	3	1	1	4	11
3-99788	injuring	city		day	How many people were injured in 15/09/2015 (day) in ('New Jersey', 'Newark') (city) ?	1	0	0	0	1	4	0
3-94097	injuring	state		day	How many people were injured in 11/05/2014 (day) in ('California',) (state) ?	1	0	0	0	1	6	0
3-98459	injuring	state		month	How many people were injured in 01/2013 (month) in ('California',) (state) ?	2	0	0	0	2	7	0
3-94096	injuring	state		day	How many people were injured in 07/11/2013 (day) in ('Michigan',) (state) ?	2	0	0	0	2	7	0
3-96275	injuring	city		month	How many people were injured in 03/2013 (month) in ('California', 'Galt') (city) ?	2	0	0	0	2	7	0
3-99302	injuring	city		day	How many people were injured in 26/03/2016 (day) in ('Maryland', 'Dundalk') (city) ?	2	0	0	0	2	2	0
3-111483	job_firing		full_name	year	How many people were fired in 2014 (year) that involve the name Ian Drysdale (full_name) ?	4	0	0	0	4	1	0
3-86470	killing		first	year	How many people were killed in 2014 (year) that involve the name Eddie (first) ?	2	2	2	0	0	1	1
3-110157	injuring	city	last		How many people were injured in ('Florida', 'Miami') (city) that involve the name Charles (last) ?	2	1	1	0	1	0	9
3-85149	killing		full_name	day	How many people were killed in 22/10/2016 (day) that involve the name Dejon Caine (full_name) ?	1	1	1	0	0	0	0
3-86477	killing		first	year	How many people were killed in 2015 (year) that involve the name Joseph (first) ?	5	5	4	1	1	1	5
3-91802	killing	city	first		How many people were killed in ('Ohio', 'Cleveland') (city) that involve the name Braylon (first) ?	3	0	0	0	3	1	0
3-98440	injuring	state		month	How many people were injured in 12/2016 (month) in ('Arkansas',) (state) ?	1	6	0	6	1	2	5
3-94088	injuring	state		day	How many people were injured in 30/10/2016 (day) in ('New York',) (state) ?	8	2	2	0	6	9	5
3-96267	injuring	city		month	How many people were injured in 06/2016 (month) in ('Minnesota', 'Webster') (city) ?	2	0	0	0	2	4	0
3-75347	killing	city		day	How many people were killed in 24/11/2016 (day) in ('New York', 'Sandy Creek') (city) ?	1	0	0	0	1	1	0
3-94085	injuring	state		day	How many people were injured in 07/08/2016 (day) in ('Mississippi',) (state) ?	2	0	0	0	2	3	0
3-98441	injuring	state		month	How many people were injured in 08/2016 (month) in ('Indiana',) (state) ?	5	6	1	5	4	5	5
3-96265	injuring	city		month	How many people were injured in 06/2015 (month) in ('New Jersey', 'Camden') (city) ?	1	0	0	0	1	3	0
3-99879	injuring	city		day	How many people were injured in 08/08/2016 (day) in ('Virginia', 'Newport News') (city) ?	2	0	0	0	2	2	0
3-108700	injuring	state	last		How many people were injured in ('New York',) (state) that involve the name Maldonado (last) ?	3	0	0	0	3	0	0
3-88746	killing	state	first		How many people were killed in ('Texas',) (state) that involve the name Jonathan (first) ?	3	6	3	3	0	0	5
3-86568	killing		first	year	How many people were killed in 2015 (year) that involve the name Jonathan (first) ?	4	7	4	3	0	1	6
3-107857	injuring	state	first		How many people were injured in ('South Carolina',) (state) that involve the name Ariel (first) ?	2	2	2	0	0	0	7
3-87894	killing	state	first		How many people were killed in ('Illinois',) (state) that involve the name Anthony (first) ?	7	3	3	0	4	0	3
3-108706	injuring	state	last		How many people were injured in ('Connecticut',) (state) that involve the name Fluker (last) ?	2	0	0	0	2	0	0
3-86562	killing		first	year	How many people were killed in 2014 (year) that involve the name Ryan (first) ?	2	0	0	0	2	1	0
3-91917	killing	city	first		How many people were killed in ('Arkansas', 'Buckner') (city) that involve the name Mike (first) ?	1	0	0	0	1	1	0
3-106529	injuring		first	day	How many people were injured in 22/11/2014 (day) that involve the name Davienne (first) ?	1	1	1	0	0	0	0
3-87409	killing		last	month	How many people were killed in 09/2016 (month) that involve the name Smith (last) ?	6	11	5	6	1	1	17
3-104349	injuring		full_name	year	How many people were injured in 2016 (year) that involve the name Adrian Potts (full_name) ?	2	1	1	0	1	0	3
3-77612	killing	city		month	How many people were killed in 01/2016 (month) in ('Pennsylvania', 'Hummelstown') (city) ?	1	0	0	0	1	1	0
3-95040	injuring	city		year	How many people were injured in 2016 (year) in ('Tennessee', 'Knoxville') (city) ?	1	3	1	2	0	1	2
3-103011	injuring		full_name	month	How many people were injured in 02/2014 (month) that involve the name Peter Andrade (full_name) ?	2	1	1	0	1	0	4
3-103495	injuring		last	year	How many people were injured in 2013 (year) that involve the name Turner (last) ?	2	2	2	0	0	1	4
3-74105	killing	state		year	How many people were killed in 2015 (year) in ('New Jersey',) (state) ?	7	4	4	0	3	7	7
3-96377	injuring	city		month	How many people were injured in 04/2016 (month) in ('Nevada', 'Las Vegas') (city) ?	5	3	3	0	2	4	6
3-105673	injuring		last	day	How many people were injured in 04/01/2016 (day) that involve the name Lusk (last) ?	1	0	0	0	1	0	0
3-74104	killing	state		year	How many people were killed in 2016 (year) in ('Oklahoma',) (state) ?	5	6	4	2	1	3	14
3-96378	injuring	city		month	How many people were injured in 10/2016 (month) in ('Ohio', 'Toledo') (city) ?	3	4	2	2	1	4	4
3-105672	injuring		last	day	How many people were injured in 08/05/2016 (day) that involve the name Benitez (last) ?	4	3	3	0	1	0	3
3-99405	injuring	city		day	How many people were injured in 05/09/2016 (day) in ('Kentucky', 'Lexington') (city) ?	1	1	1	0	0	1	0
3-74102	killing	state		year	How many people were killed in 2015 (year) in ('Alabama',) (state) ?	2	1	1	0	1	4	3
3-94195	injuring	state		day	How many people were injured in 08/03/2014 (day) in ('California',) (state) ?	1	1	1	0	0	3	3
3-99888	injuring	city		day	How many people were injured in 15/08/2015 (day) in ('Pennsylvania', 'Pittsburgh') (city) ?	2	2	2	0	0	3	3
3-74101	killing	state		year	How many people were killed in 2016 (year) in ('Colorado',) (state) ?	20	17	14	3	6	11	14
3-95048	injuring	city		year	How many people were injured in 2015 (year) in ('California', 'Stockton') (city) ?	4	0	0	0	4	11	0
3-96375	injuring	city		month	How many people were injured in 12/2016 (month) in ('Maryland', 'Baltimore') (city) ?	1	0	0	0	1	5	0
3-99885	injuring	city		day	How many people were injured in 14/03/2016 (day) in ('Tennessee', 'Chattanooga') (city) ?	2	0	0	0	2	1	0
3-95029	injuring	city		year	How many people were injured in 2015 (year) in ('Missouri', 'Saint Louis') (city) ?	4	2	1	1	3	10	5
3-95028	injuring	city		year	How many people were injured in 2016 (year) in ('Pennsylvania', 'Pittsburgh') (city) ?	11	19	10	9	1	11	37
3-99869	injuring	city		day	How many people were injured in 10/06/2013 (day) in ('Missouri', 'St Louis') (city) ?	3	2	2	0	1	6	7
3-74107	killing	state		year	How many people were killed in 2016 (year) in ('Alabama',) (state) ?	12	9	4	5	8	12	14
3-74106	killing	state		year	How many people were killed in 2015 (year) in ('Illinois',) (state) ?	21	10	4	6	17	13	23
3-84398	killing		full_name	month	How many people were killed in 06/2016 (month) that involve the name Alac Jackson (full_name) ?	3	1	1	0	2	1	1
3-77619	killing	city		month	How many people were killed in 10/2016 (month) in ('Alabama', 'Mobile') (city) ?	1	0	0	0	1	1	0
3-106518	injuring		first	day	How many people were injured in 06/12/2015 (day) that involve the name Kachelle (first) ?	1	1	1	0	0	1	2
3-99870	injuring	city		day	How many people were injured in 06/10/2013 (day) in ('Arizona', 'Avondale') (city) ?	1	1	1	0	0	4	4
3-105668	injuring		last	day	How many people were injured in 20/07/2015 (day) that involve the name Sall (last) ?	2	0	0	0	2	0	0
3-103487	injuring		last	year	How many people were injured in 2016 (year) that involve the name Johnson (last) ?	9	38	5	33	4	1	46
3-94187	injuring	state		day	How many people were injured in 02/11/2013 (day) in ('Kentucky',) (state) ?	1	1	1	0	0	3	3
3-99876	injuring	city		day	How many people were injured in 10/03/2013 (day) in ('Kansas', 'Kansas City') (city) ?	2	0	0	0	2	5	0
3-102151	injuring		last	month	How many people were injured in 11/2013 (month) that involve the name White (last) ?	3	0	0	0	3	0	0
3-74115	killing	state		year	How many people were killed in 2014 (year) in ('Florida',) (state) ?	10	11	7	4	3	10	14
3-98544	injuring	state		month	How many people were injured in 06/2014 (month) in ('Massachusetts',) (state) ?	2	1	1	0	1	5	0
3-98547	injuring	state		month	How many people were injured in 07/2015 (month) in ('Indiana',) (state) ?	3	3	3	0	0	12	7
3-74113	killing	state		year	How many people were killed in 2013 (year) in ('Michigan',) (state) ?	4	0	0	0	4	4	0
3-106990	injuring	city	first		How many people were injured in ('Tennessee', 'Memphis') (city) that involve the name Willis (first) ?	1	1	1	0	0	0	2
3-75443	killing	city		day	How many people were killed in 02/12/2015 (day) in ('Georgia', 'Savannah') (city) ?	1	0	0	0	1	1	0
3-95038	injuring	city		year	How many people were injured in 2015 (year) in ('Arizona', 'Phoenix') (city) ?	2	3	1	2	1	4	5
3-98541	injuring	state		month	How many people were injured in 07/2016 (month) in ('Arizona',) (state) ?	1	2	1	1	0	6	2
3-96363	injuring	city		month	How many people were injured in 06/2015 (month) in ('Florida', 'Miami Gardens') (city) ?	1	1	1	0	0	4	0
3-99871	injuring	city		day	How many people were injured in 28/08/2016 (day) in ('Alabama', 'Dadeville') (city) ?	1	1	1	0	0	5	5
3-74110	killing	state		year	How many people were killed in 2013 (year) in ('Pennsylvania',) (state) ?	3	5	2	3	1	2	4
3-95036	injuring	city		year	How many people were injured in 2015 (year) in ('Texas', 'San Antonio') (city) ?	7	2	2	0	5	9	2
3-98529	injuring	state		month	How many people were injured in 12/2014 (month) in ('Illinois',) (state) ?	4	2	2	0	2	13	8
3-75404	killing	city		day	How many people were killed in 03/09/2016 (day) in ('California', 'Oceanside') (city) ?	1	0	0	0	1	1	0
3-82187	killing		last	year	How many people were killed in 2016 (year) that involve the name Dieudonne (last) ?	3	1	1	0	2	1	0
3-84365	killing		full_name	month	How many people were killed in 01/2015 (month) that involve the name Ivan Berrien (full_name) ?	3	1	1	0	2	0	0
3-85699	killing		first	year	How many people were killed in 2016 (year) that involve the name Morris (first) ?	1	1	1	0	0	1	0
3-108727	injuring	state	last		How many people were injured in ('California',) (state) that involve the name Taylor (last) ?	4	2	0	2	4	0	8
3-82184	killing		last	year	How many people were killed in 2015 (year) that involve the name Martin (last) ?	4	2	1	1	3	1	0
3-85692	killing		first	year	How many people were killed in 2016 (year) that involve the name James (first) ?	11	30	5	25	6	4	14
3-87871	killing	state	first		How many people were killed in ('Texas',) (state) that involve the name Braveon (first) ?	2	1	1	0	1	1	0
3-108719	injuring	state	last		How many people were injured in ('Virginia',) (state) that involve the name Brown (last) ?	1	1	1	0	0	0	0
3-96350	injuring	city		month	How many people were injured in 02/2013 (month) in ('California', 'Lancaster') (city) ?	3	0	0	0	3	4	0
3-87867	killing	state	first		How many people were killed in ('Texas',) (state) that involve the name Alan (first) ?	6	1	1	0	5	0	0
3-75414	killing	city		day	How many people were killed in 07/12/2015 (day) in ('Tennessee', 'Cleveland') (city) ?	2	0	0	0	2	2	0
3-99865	injuring	city		day	How many people were injured in 01/07/2015 (day) in ('Kentucky', 'Lexington') (city) ?	1	0	0	0	1	1	0
3-102184	injuring		last	month	How many people were injured in 09/2016 (month) that involve the name Green (last) ?	7	5	4	1	3	3	6
3-75413	killing	city		day	How many people were killed in 04/07/2016 (day) in ('Arizona', 'Phoenix') (city) ?	1	1	1	0	0	2	2
3-75894	killing	city		day	How many people were killed in 07/07/2015 (day) in ('Maryland', 'Baltimore') (city) ?	1	0	0	0	1	3	0
3-96351	injuring	city		month	How many people were injured in 07/2016 (month) in ('Florida', 'Saint Petersburg') (city) ?	1	0	0	0	1	1	0
3-99860	injuring	city		day	How many people were injured in 01/11/2015 (day) in ('Ohio', 'Dayton') (city) ?	1	0	0	0	1	1	0
3-94177	injuring	state		day	How many people were injured in 08/04/2016 (day) in ('District of Columbia',) (state) ?	1	0	0	0	1	1	0
3-96354	injuring	city		month	How many people were injured in 11/2016 (month) in ('Louisiana', 'Baton Rouge') (city) ?	2	2	2	0	0	1	1
3-99862	injuring	city		day	How many people were injured in 16/09/2016 (day) in ('Texas', 'Dallas') (city) ?	3	0	0	0	3	2	0
3-98519	injuring	state		month	How many people were injured in 06/2016 (month) in ('Massachusetts',) (state) ?	7	9	6	3	1	5	15
3-82192	killing		last	year	How many people were killed in 2014 (year) that involve the name Hernandez (last) ?	2	1	1	0	1	2	2
3-95007	injuring	city		year	How many people were injured in 2016 (year) in ('Illinois', 'Rockford') (city) ?	3	0	0	0	3	6	0
3-94159	injuring	state		day	How many people were injured in 05/09/2015 (day) in ('Nevada',) (state) ?	2	2	2	0	0	3	3
3-98515	injuring	state		month	How many people were injured in 01/2015 (month) in ('Virginia',) (state) ?	2	1	1	0	1	6	5
3-99846	injuring	city		day	How many people were injured in 23/05/2016 (day) in ('New Jersey', 'Newark') (city) ?	1	0	0	0	1	5	0
3-99849	injuring	city		day	How many people were injured in 31/03/2016 (day) in ('Illinois', 'Chicago (Englewood)') (city) ?	1	0	0	0	1	4	0
3-87401	killing		last	month	How many people were killed in 08/2016 (month) that involve the name Rosado (last) ?	2	1	1	0	1	0	0
3-78929	killing		first	month	How many people were killed in 01/2015 (month) that involve the name Joseph (first) ?	2	2	1	1	1	0	3
3-103026	injuring		full_name	month	How many people were injured in 05/2016 (month) that involve the name Peter Noack (full_name) ?	2	2	2	0	0	0	0
3-102177	injuring		last	month	How many people were injured in 05/2014 (month) that involve the name Brooks (last) ?	2	2	2	0	0	0	8
3-105204	injuring		full_name	day	How many people were injured in 23/04/2016 (day) that involve the name Angelo Barboza (full_name) ?	4	2	2	0	2	0	7
3-105203	injuring		full_name	day	How many people were injured in 15/09/2015 (day) that involve the name Rob'Dasha Smith (full_name) ?	3	0	0	0	3	1	0
3-86547	killing		first	year	How many people were killed in 2016 (year) that involve the name Jamie (first) ?	4	9	3	6	1	1	9
3-77603	killing	city		month	How many people were killed in 11/2016 (month) in ('Virginia', 'Christiansburg') (city) ?	2	0	0	0	2	1	0
3-96345	injuring	city		month	How many people were injured in 12/2013 (month) in ('New York', 'Medford') (city) ?	2	0	0	0	2	3	0
3-102175	injuring		last	month	How many people were injured in 06/2015 (month) that involve the name Jones (last) ?	4	2	2	0	2	2	1
3-75422	killing	city		day	How many people were killed in 28/06/2016 (day) in ('California', 'Los Angeles (county)') (city) ?	1	0	0	0	1	1	0
3-95016	injuring	city		year	How many people were injured in 2013 (year) in ('California', 'Oakland') (city) ?	5	0	0	0	5	11	0
3-95014	injuring	city		year	How many people were injured in 2013 (year) in ('California', 'Long Beach') (city) ?	1	0	0	0	1	2	0
3-94166	injuring	state		day	How many people were injured in 13/10/2016 (day) in ('Illinois',) (state) ?	1	0	0	0	1	4	0
3-96343	injuring	city		month	How many people were injured in 12/2016 (month) in ('Virginia', 'Richmond') (city) ?	2	1	1	0	1	1	0
3-98508	injuring	state		month	How many people were injured in 11/2013 (month) in ('Michigan',) (state) ?	3	1	1	0	2	12	5
3-98989	injuring	city		day	How many people were injured in 20/08/2016 (day) in ('South Carolina', 'Columbia') (city) ?	1	0	0	0	1	1	0
3-98988	injuring	city		day	How many people were injured in 26/11/2015 (day) in ('Indiana', 'Indianapolis') (city) ?	1	0	0	0	1	1	0
3-99838	injuring	city		day	How many people were injured in 25/09/2015 (day) in ('Illinois', 'Danville') (city) ?	1	0	0	0	1	4	0
3-98506	injuring	state		month	How many people were injured in 01/2015 (month) in ('Florida',) (state) ?	2	2	1	1	1	6	3
3-76715	killing	state		day	How many people were killed in 25/05/2015 (day) in ('Virginia',) (state) ?	3	1	1	0	2	1	0
3-76716	killing	state		day	How many people were killed in 05/09/2016 (day) in ('New York',) (state) ?	3	0	0	0	3	2	0
3-85673	killing		first	year	How many people were killed in 2016 (year) that involve the name Reginald (first) ?	4	5	3	2	1	1	3
3-82164	killing		last	year	How many people were killed in 2013 (year) that involve the name Jones (last) ?	5	8	3	5	2	2	8
3-84341	killing		full_name	month	How many people were killed in 06/2016 (month) that involve the name Oliver Kennedy (full_name) ?	3	0	0	0	3	0	0
3-86518	killing		first	year	How many people were killed in 2016 (year) that involve the name Jordan (first) ?	11	5	5	0	6	0	1
3-103458	injuring		last	year	How many people were injured in 2016 (year) that involve the name Jones (last) ?	13	22	6	16	7	3	24
3-104786	injuring		full_name	year	How many people were injured in 2016 (year) that involve the name Leonard Moses (full_name) ?	2	1	1	0	1	0	6
3-84337	killing		full_name	month	How many people were killed in 04/2016 (month) that involve the name Ja'Terreon Thorne (full_name) ?	2	0	0	0	2	1	0
3-85668	killing		first	year	How many people were killed in 2016 (year) that involve the name Brennan (first) ?	1	1	1	0	0	1	0
3-102122	injuring		last	month	How many people were injured in 11/2013 (month) that involve the name Young (last) ?	5	2	2	0	3	0	2
3-104303	injuring		full_name	year	How many people were injured in 2015 (year) that involve the name Malik Jones (full_name) ?	2	1	1	0	1	0	0
3-82159	killing		last	year	How many people were killed in 2014 (year) that involve the name Roberts (last) ?	3	4	2	2	1	2	2
3-84336	killing		full_name	month	How many people were killed in 11/2015 (month) that involve the name Kenerick Taylor (full_name) ?	1	1	1	0	0	0	0
3-104301	injuring		full_name	year	How many people were injured in 2016 (year) that involve the name Edward Tillman (full_name) ?	2	1	1	0	1	0	0
3-101272	injuring		first	month	How many people were injured in 11/2016 (month) that involve the name Torius (first) ?	3	2	2	0	1	0	15
3-98996	injuring	city		day	How many people were injured in 02/05/2013 (day) in ('New Jersey', 'Newark') (city) ?	1	1	1	0	0	5	5
3-104781	injuring		full_name	year	How many people were injured in 2016 (year) that involve the name Angel Nelms (full_name) ?	4	1	1	0	3	1	0
3-98997	injuring	city		day	How many people were injured in 15/12/2016 (day) in ('Texas', 'San Angelo') (city) ?	1	0	0	0	1	1	0
3-94158	injuring	state		day	How many people were injured in 27/02/2015 (day) in ('Nevada',) (state) ?	1	1	1	0	0	1	0
3-75870	killing	city		day	How many people were killed in 26/11/2016 (day) in ('Pennsylvania', 'Pittsburgh') (city) ?	1	1	1	0	0	1	2
3-95003	injuring	city		year	How many people were injured in 2016 (year) in ('Alabama', 'Birmingham') (city) ?	2	0	0	0	2	4	0
3-99840	injuring	city		day	How many people were injured in 25/08/2013 (day) in ('California', 'Oakland') (city) ?	2	0	0	0	2	4	0
3-96319	injuring	city		month	How many people were injured in 07/2015 (month) in ('California', 'Santa Paula') (city) ?	1	1	1	0	0	5	0
3-94138	injuring	state		day	How many people were injured in 07/09/2015 (day) in ('Colorado',) (state) ?	2	1	1	0	1	4	1
3-99825	injuring	city		day	How many people were injured in 03/01/2016 (day) in ('Texas', 'Spring') (city) ?	2	0	0	0	2	1	0
3-99824	injuring	city		day	How many people were injured in 10/08/2016 (day) in ('California', 'San Francisco') (city) ?	1	1	1	0	0	1	3
3-96318	injuring	city		month	How many people were injured in 12/2016 (month) in ('Florida', 'Titusville') (city) ?	2	2	2	0	0	1	0
3-85686	killing		first	year	How many people were killed in 2014 (year) that involve the name Antrez (first) ?	1	1	1	0	0	1	2
3-86532	killing		first	year	How many people were killed in 2016 (year) that involve the name Leonard (first) ?	4	2	2	0	2	1	2
3-84356	killing		full_name	month	How many people were killed in 06/2014 (month) that involve the name Juan Acosta (full_name) ?	1	1	1	0	0	0	1
3-82172	killing		last	year	How many people were killed in 2016 (year) that involve the name Romero-Sanchez (last) ?	3	1	1	0	2	1	0
3-78906	killing		first	month	How many people were killed in 09/2016 (month) that involve the name Jacob (first) ?	5	3	3	0	2	2	1
3-107805	injuring	state	first		How many people were injured in ('Connecticut',) (state) that involve the name Ivette (first) ?	4	3	3	0	1	1	10
3-76730	killing	state		day	How many people were killed in 16/11/2016 (day) in ('Arkansas',) (state) ?	1	0	0	0	1	1	0
3-85678	killing		first	year	How many people were killed in 2014 (year) that involve the name Brandon (first) ?	3	4	3	1	0	2	2
3-104774	injuring		full_name	year	How many people were injured in 2016 (year) that involve the name Ava Schowalter (full_name) ?	2	1	1	0	1	1	0
3-75403	killing	city		day	How many people were killed in 10/12/2016 (day) in ('Florida', 'West Palm Beach') (city) ?	1	0	0	0	1	2	0
3-75887	killing	city		day	How many people were killed in 07/10/2016 (day) in ('Texas', 'Houston') (city) ?	2	0	0	0	2	1	0
3-96322	injuring	city		month	How many people were injured in 06/2014 (month) in ('Florida', 'Miami') (city) ?	2	3	2	1	0	7	4
3-103441	injuring		last	year	How many people were injured in 2013 (year) that involve the name Garcia (last) ?	5	5	3	2	2	1	8
3-75886	killing	city		day	How many people were killed in 05/09/2016 (day) in ('Michigan', 'Kalamazoo') (city) ?	3	0	0	0	3	2	0
3-94141	injuring	state		day	How many people were injured in 11/07/2016 (day) in ('Kansas',) (state) ?	2	1	1	0	1	3	0
3-98502	injuring	state		month	How many people were injured in 08/2016 (month) in ('Minnesota',) (state) ?	2	2	2	0	0	5	3
3-98983	injuring	city		day	How many people were injured in 06/07/2014 (day) in ('Florida', 'Miami') (city) ?	2	2	2	0	0	2	11
3-94144	injuring	state		day	How many people were injured in 28/08/2015 (day) in ('New York',) (state) ?	1	0	0	0	1	3	0
3-94129	injuring	state		day	How many people were injured in 01/09/2016 (day) in ('Illinois',) (state) ?	3	1	1	0	2	3	3
3-96308	injuring	city		month	How many people were injured in 06/2013 (month) in ('Texas', 'Houston') (city) ?	3	3	3	0	0	3	9
3-111099	injuring	state	full_name		How many people were injured in ('Indiana',) (state) that involve the name DeJour Martin (full_name) ?	1	1	1	0	0	1	0
3-74999	killing	city		year	How many people were killed in 2016 (year) in ('California', 'Long Beach') (city) ?	3	0	0	0	3	3	0
3-99816	injuring	city		day	How many people were injured in 23/03/2014 (day) in ('California', 'San Francisco') (city) ?	2	2	2	0	0	7	8
3-74997	killing	city		year	How many people were killed in 2016 (year) in ('Florida', 'Pensacola') (city) ?	3	2	2	0	1	2	0
3-96307	injuring	city		month	How many people were injured in 08/2016 (month) in ('Virginia', 'Norfolk') (city) ?	1	2	1	1	0	4	4
3-98968	injuring	city		day	How many people were injured in 08/05/2016 (day) in ('Texas', 'Austin') (city) ?	4	1	1	0	3	3	0
3-99815	injuring	city		day	How many people were injured in 11/06/2016 (day) in ('North Carolina', 'Charlotte') (city) ?	2	0	0	0	2	3	0
3-107832	injuring	state	first		How many people were injured in ('Florida',) (state) that involve the name Kody (first) ?	1	0	0	0	1	0	0
3-87830	killing	state	first		How many people were killed in ('Texas',) (state) that involve the name Ryan (first) ?	5	6	4	2	1	1	6
3-85654	killing		first	year	How many people were killed in 2016 (year) that involve the name Brandon (first) ?	6	11	4	7	2	1	3
3-84320	killing		full_name	month	How many people were killed in 08/2016 (month) that involve the name William Dabill (full_name) ?	2	2	2	0	0	0	0
3-104322	injuring		full_name	year	How many people were injured in 2015 (year) that involve the name Howard Reno (full_name) ?	1	1	1	0	0	0	0
3-98973	injuring	city		day	How many people were injured in 12/06/2015 (day) in ('Florida', 'Allapattah') (city) ?	1	1	1	0	0	4	4
3-106981	injuring	city	first		How many people were injured in ('Florida', 'Miami') (city) that involve the name Anthony (first) ?	2	2	1	1	1	1	1
3-93289	killing	state	last		How many people were killed in ('Massachusetts',) (state) that involve the name Merced (last) ?	2	0	0	0	2	1	0
3-94136	injuring	state		day	How many people were injured in 20/12/2015 (day) in ('Florida',) (state) ?	1	1	1	0	0	4	4
3-93287	killing	state	last		How many people were killed in ('Florida',) (state) that involve the name Louis (last) ?	2	1	1	0	1	0	2
3-94134	injuring	state		day	How many people were injured in 08/10/2016 (day) in ('California',) (state) ?	3	3	2	1	1	1	3
3-98971	injuring	city		day	How many people were injured in 14/07/2016 (day) in ('California', 'Oakland') (city) ?	1	0	0	0	1	4	0
3-99805	injuring	city		day	How many people were injured in 09/11/2015 (day) in ('Indiana', 'Indianapolis') (city) ?	3	1	1	0	2	2	4
3-98957	injuring	city		day	How many people were injured in 17/12/2016 (day) in ('California', 'Oceanside') (city) ?	2	0	0	0	2	1	0
3-85666	killing		first	year	How many people were killed in 2015 (year) that involve the name Shawn (first) ?	3	4	3	1	0	1	0
3-83000	killing		last	day	How many people were killed in 05/11/2016 (day) that involve the name Cadenbach (last) ?	1	1	1	0	0	3	0
3-103466	injuring		last	year	How many people were injured in 2013 (year) that involve the name Figueredo (last) ?	2	1	1	0	1	0	3
3-91092	killing	state	full_name		How many people were killed in ('Georgia',) (state) that involve the name Thy Ho (full_name) ?	1	1	1	0	0	1	0
3-104794	injuring		full_name	year	How many people were injured in 2013 (year) that involve the name Ronald Smith (full_name) ?	2	2	2	0	0	1	7
3-99812	injuring	city		day	How many people were injured in 12/08/2016 (day) in ('Texas', 'Corpus Christi') (city) ?	1	1	1	0	0	1	0
3-93258	killing	state	last		How many people were killed in ('Florida',) (state) that involve the name Thompson (last) ?	4	1	1	0	3	1	0
3-107454	injuring	city	first		How many people were injured in ('California', 'Long Beach') (city) that involve the name David (first) ?	2	0	0	0	2	0	0
3-82122	killing		last	year	How many people were killed in 2015 (year) that involve the name Price (last) ?	9	5	5	0	4	2	7
3-100816	injuring		first	year	How many people were injured in 2015 (year) that involve the name David (first) ?	5	19	2	17	3	0	11
3-84780	killing		full_name	day	How many people were killed in 10/06/2013 (day) that involve the name April McDaniel (full_name) ?	1	1	1	0	0	1	2
3-87807	killing	state	first		How many people were killed in ('Florida',) (state) that involve the name Cartrez (first) ?	2	1	1	0	1	0	0
3-82114	killing		last	year	How many people were killed in 2016 (year) that involve the name Williams (last) ?	4	28	3	25	1	3	32
3-94590	injuring	city		year	How many people were injured in 2015 (year) in ('District of Columbia', 'Washington') (city) ?	1	0	0	0	1	5	0
3-84779	killing		full_name	day	How many people were killed in 21/12/2014 (day) that involve the name Dewayne Purnell (full_name) ?	2	2	2	0	0	1	1
3-94110	injuring	state		day	How many people were injured in 29/11/2015 (day) in ('Washington',) (state) ?	3	4	3	1	0	1	0
3-94594	injuring	city		year	How many people were injured in 2015 (year) in ('Maryland', 'Baltimore') (city) ?	11	8	6	2	5	37	25
3-94593	injuring	city		year	How many people were injured in 2016 (year) in ('Texas', 'San Antonio') (city) ?	13	16	12	4	1	18	31
3-105275	injuring		full_name	day	How many people were injured in 10/11/2016 (day) that involve the name Michael Walls (full_name) ?	3	1	1	0	2	0	0
3-106122	injuring		last	day	How many people were injured in 03/02/2014 (day) that involve the name Davis (last) ?	1	0	0	0	1	0	0
3-99800	injuring	city		day	How many people were injured in 06/07/2014 (day) in ('New York', 'Buffalo') (city) ?	1	1	1	0	0	4	4
3-94596	injuring	city		year	How many people were injured in 2013 (year) in ('Indiana', 'Indianapolis') (city) ?	5	1	1	0	4	11	1
3-91087	killing	state	full_name		How many people were killed in ('California',) (state) that involve the name Jerry Chim (full_name) ?	1	1	1	0	0	1	2
3-75837	killing	city		day	How many people were killed in 21/12/2014 (day) in ('Nevada', 'Las Vegas') (city) ?	1	1	1	0	0	1	2
3-74986	killing	city		year	How many people were killed in 2015 (year) in ('Arizona', 'Tucson') (city) ?	2	4	1	3	1	6	1
3-108777	injuring	state	last		How many people were injured in ('Louisiana',) (state) that involve the name Le (last) ?	5	3	2	1	3	0	27
3-85643	killing		first	year	How many people were killed in 2016 (year) that involve the name Mariah (first) ?	6	3	3	0	3	2	8
3-81282	killing		full_name	year	How many people were killed in 2016 (year) that involve the name Lance Buckley (full_name) ?	2	2	2	0	0	1	4
3-100802	injuring		first	year	How many people were injured in 2016 (year) that involve the name Lawrence (first) ?	5	7	2	5	3	1	0
3-83462	killing		last	day	How many people were killed in 17/09/2016 (day) that involve the name Copeland (last) ?	1	1	1	0	0	0	0
3-85639	killing		first	year	How many people were killed in 2016 (year) that involve the name Jesse (first) ?	6	7	5	2	1	0	4
3-85638	killing		first	year	How many people were killed in 2015 (year) that involve the name David (first) ?	4	7	1	6	3	0	7
3-106118	injuring		last	day	How many people were injured in 05/09/2016 (day) that involve the name Borel (last) ?	3	3	3	0	0	0	5
3-85635	killing		first	year	How many people were killed in 2016 (year) that involve the name Darian (first) ?	3	2	2	0	1	1	0
3-93252	killing	state	last		How many people were killed in ('Georgia',) (state) that involve the name Al-Hussien (last) ?	1	1	1	0	0	0	0
3-94583	injuring	city		year	How many people were injured in 2015 (year) in ('Texas', 'Corpus Christi') (city) ?	2	2	2	0	0	1	1
3-94580	injuring	city		year	How many people were injured in 2016 (year) in ('Florida', 'Apopka') (city) ?	1	3	1	2	0	1	2
3-98927	injuring	city		day	How many people were injured in 26/06/2016 (day) in ('Georgia', 'Atlanta') (city) ?	2	0	0	0	2	4	0
3-98926	injuring	city		day	How many people were injured in 29/04/2016 (day) in ('California', 'Oakland') (city) ?	1	0	0	0	1	5	0
3-75805	killing	city		day	How many people were killed in 10/11/2016 (day) in ('Oregon', 'Salem') (city) ?	1	0	0	0	1	1	0
3-98929	injuring	city		day	How many people were injured in 18/10/2015 (day) in ('Louisiana', 'New Orleans') (city) ?	1	1	1	0	0	4	4
3-74957	killing	city		year	How many people were killed in 2014 (year) in ('Florida', 'Miami') (city) ?	6	6	6	0	0	6	9
3-75803	killing	city		day	How many people were killed in 10/05/2014 (day) in ('California', 'Sacramento') (city) ?	1	2	1	1	0	1	6
3-74955	killing	city		year	How many people were killed in 2016 (year) in ('Texas', 'Houston') (city) ?	31	24	20	4	11	15	28
3-110640	injuring	state	full_name		How many people were injured in ('California',) (state) that involve the name Dejuan Gladney (full_name) ?	1	0	0	0	1	0	0
3-74954	killing	city		year	How many people were killed in 2016 (year) in ('Alabama', 'Birmingham') (city) ?	3	0	0	0	3	2	0
3-98925	injuring	city		day	How many people were injured in 26/11/2016 (day) in ('Pennsylvania', 'Pittsburgh') (city) ?	1	1	1	0	0	2	2
3-81252	killing		full_name	year	How many people were killed in 2015 (year) that involve the name Ross Anderson (full_name) ?	2	2	2	0	0	0	5
3-83430	killing		last	day	How many people were killed in 04/11/2016 (day) that involve the name Hutton (last) ?	2	1	1	0	1	1	0
3-82581	killing		last	year	How many people were killed in 2015 (year) that involve the name Burns (last) ?	4	3	3	0	1	2	2
3-83425	killing		last	day	How many people were killed in 22/12/2015 (day) that involve the name Seichter (last) ?	1	0	0	0	1	1	0
3-85604	killing		first	year	How many people were killed in 2016 (year) that involve the name Edward (first) ?	2	5	2	3	0	2	2
3-106146	injuring		last	day	How many people were injured in 11/06/2016 (day) that involve the name Brown (last) ?	2	0	0	0	2	2	0
3-74961	killing	city		year	How many people were killed in 2016 (year) in ('Florida', 'Tampa') (city) ?	5	0	0	0	5	2	0
3-98931	injuring	city		day	How many people were injured in 27/11/2015 (day) in ('California', 'Sacramento') (city) ?	2	0	0	0	2	2	0
3-105296	injuring		full_name	day	How many people were injured in 10/05/2014 (day) that involve the name Antwan Wheeler (full_name) ?	1	0	0	0	1	0	0
3-110638	injuring	state	full_name		How many people were injured in ('Georgia',) (state) that involve the name Eugene Roberts (full_name) ?	2	1	1	0	1	0	3
3-94558	injuring	city		year	How many people were injured in 2016 (year) in ('Ohio', 'Cleveland') (city) ?	6	8	1	7	5	7	7
3-75817	killing	city		day	How many people were killed in 27/02/2015 (day) in ('Texas', 'Houston') (city) ?	2	0	0	0	2	1	0
3-94557	injuring	city		year	How many people were injured in 2015 (year) in ('Alabama', 'Birmingham') (city) ?	2	1	0	1	2	2	0
3-98915	injuring	city		day	How many people were injured in 25/02/2016 (day) in ('Ohio', 'Cleveland') (city) ?	1	0	0	0	1	1	0
3-95887	injuring	city		month	How many people were injured in 03/2016 (month) in ('California', 'Oakland') (city) ?	1	0	0	0	1	4	0
3-95888	injuring	city		month	How many people were injured in 04/2015 (month) in ('Alabama', 'Montgomery') (city) ?	1	0	0	0	1	5	0
3-93228	killing	state	last		How many people were killed in ('Texas',) (state) that involve the name Howard (last) ?	8	3	3	0	5	1	0
3-94559	injuring	city		year	How many people were injured in 2015 (year) in ('South Dakota', 'Letcher') (city) ?	1	0	0	0	1	1	0
3-95889	injuring	city		month	How many people were injured in 03/2015 (month) in ('Georgia', 'Atlanta') (city) ?	2	2	2	0	0	5	10
3-108799	injuring	state	last		How many people were injured in ('Florida',) (state) that involve the name Thompson (last) ?	4	1	1	0	3	0	1
3-100824	injuring		first	year	How many people were injured in 2016 (year) that involve the name Biyaga (first) ?	1	1	1	0	0	0	0
3-82588	killing		last	year	How many people were killed in 2016 (year) that involve the name Long (last) ?	4	4	3	1	1	3	0
3-85612	killing		first	year	How many people were killed in 2015 (year) that involve the name Jamie (first) ?	3	5	3	2	0	0	4
3-74974	killing	city		year	How many people were killed in 2016 (year) in ('Arizona', 'Phoenix') (city) ?	3	5	3	2	0	4	4
3-105288	injuring		full_name	day	How many people were injured in 29/08/2016 (day) that involve the name Elijah Sims (full_name) ?	1	1	1	0	0	0	2
3-74973	killing	city		year	How many people were killed in 2015 (year) in ('Missouri', 'Kansas City') (city) ?	1	2	1	1	0	1	0
3-74972	killing	city		year	How many people were killed in 2015 (year) in ('Washington', 'Shelton') (city) ?	1	0	0	0	1	2	0
3-105286	injuring		full_name	day	How many people were injured in 03/11/2016 (day) that involve the name Emoni House (full_name) ?	2	2	2	0	0	0	2
3-95891	injuring	city		month	How many people were injured in 09/2015 (month) in ('Indiana', 'Gary') (city) ?	1	0	0	0	1	4	0
3-94562	injuring	city		year	How many people were injured in 2016 (year) in ('New York', 'Buffalo') (city) ?	2	3	2	1	0	2	7
3-74936	killing	city		year	How many people were killed in 2016 (year) in ('West Virginia', 'Troy') (city) ?	3	0	0	0	3	1	0
3-93698	injuring	state		day	How many people were injured in 03/09/2016 (day) in ('North Carolina',) (state) ?	2	0	0	0	2	3	0
3-94545	injuring	city		year	How many people were injured in 2016 (year) in ('Texas', 'Houston') (city) ?	31	32	21	11	10	36	50
3-107893	injuring	state	first		How many people were injured in ('Illinois',) (state) that involve the name Elijah (first) ?	5	2	2	0	3	0	2
3-98901	injuring	city		day	How many people were injured in 28/12/2016 (day) in ('Florida', 'Crestview') (city) ?	1	0	0	0	1	1	0
3-91039	killing	state	full_name		How many people were killed in ('Illinois',) (state) that involve the name Javon Wilson (full_name) ?	3	1	1	0	2	1	3
3-94549	injuring	city		year	How many people were injured in 2016 (year) in ('Mississippi', 'Meridian') (city) ?	1	0	0	0	1	1	0
3-80381	killing		first	day	How many people were killed in 27/12/2014 (day) that involve the name Liesel (first) ?	2	2	2	0	0	1	0
3-84742	killing		full_name	month	How many people were killed in 06/2016 (month) that involve the name Eric McKoy (full_name) ?	6	1	1	0	5	0	0
3-98909	injuring	city		day	How many people were injured in 25/07/2016 (day) in ('New York', 'Dunkirk') (city) ?	1	0	0	0	1	1	0
3-103059	injuring		full_name	month	How many people were injured in 09/2016 (month) that involve the name Jacob Hall (full_name) ?	3	2	2	0	1	0	1
3-103055	injuring		full_name	month	How many people were injured in 06/2016 (month) that involve the name Codie Powell (full_name) ?	1	0	0	0	1	0	0
3-95885	injuring	city		month	How many people were injured in 09/2016 (month) in ('Michigan', 'Saginaw') (city) ?	3	1	1	0	2	5	0
3-94554	injuring	city		year	How many people were injured in 2016 (year) in ('Maryland', 'Baltimore') (city) ?	16	6	4	2	12	38	13
3-86919	killing		last	month	How many people were killed in 07/2016 (month) that involve the name Brumby (last) ?	2	2	2	0	0	1	2
3-74946	killing	city		year	How many people were killed in 2015 (year) in ('Pennsylvania', 'Pittsburgh') (city) ?	3	6	2	4	1	2	6
3-93686	injuring	state		day	How many people were injured in 14/09/2016 (day) in ('Texas',) (state) ?	3	2	2	0	1	3	3
3-94533	injuring	city		year	How many people were injured in 2016 (year) in ('Illinois', 'Champaign') (city) ?	5	0	0	0	5	3	0
3-74944	killing	city		year	How many people were killed in 2014 (year) in ('Texas', 'Houston') (city) ?	2	1	0	1	2	2	0
3-94538	injuring	city		year	How many people were injured in 2015 (year) in ('Ohio', 'Dayton') (city) ?	4	7	2	5	2	11	5
3-95867	injuring	city		month	How many people were injured in 04/2016 (month) in ('Florida', 'Miami') (city) ?	4	4	3	1	1	5	2
3-86931	killing		last	month	How many people were killed in 11/2015 (month) that involve the name Edwards (last) ?	6	1	1	0	5	1	3
3-84748	killing		full_name	month	How many people were killed in 09/2016 (month) that involve the name Nina Green (full_name) ?	1	1	1	0	0	0	1
3-86925	killing		last	month	How many people were killed in 11/2016 (month) that involve the name Hutton (last) ?	5	3	3	0	2	4	5
3-83414	killing		last	day	How many people were killed in 27/08/2015 (day) that involve the name Legaspi (last) ?	1	1	1	0	0	2	2
3-82568	killing		last	year	How many people were killed in 2016 (year) that involve the name Pickett (last) ?	2	2	2	0	0	0	2
3-83898	killing		full_name	month	How many people were killed in 11/2016 (month) that involve the name Christopher Cadenbach (full_name) ?	1	1	1	0	0	1	0
3-102196	injuring		last	month	How many people were injured in 09/2016 (month) that involve the name Smith (last) ?	8	14	5	9	3	3	29
3-95871	injuring	city		month	How many people were injured in 05/2013 (month) in ('Arizona', 'Apache Junction') (city) ?	1	1	1	0	0	5	4
3-74951	killing	city		year	How many people were killed in 2016 (year) in ('Texas', 'Channelview') (city) ?	1	1	1	0	0	4	3
3-95873	injuring	city		month	How many people were injured in 07/2015 (month) in ('Tennessee', 'Nashville') (city) ?	2	2	2	0	0	2	0
3-95874	injuring	city		month	How many people were injured in 12/2016 (month) in ('Alabama', 'Montgomery') (city) ?	1	0	0	0	1	2	0
3-94542	injuring	city		year	How many people were injured in 2013 (year) in ('California', 'Fresno') (city) ?	2	0	0	0	2	16	0
3-74914	killing	city		year	How many people were killed in 2016 (year) in ('Texas', 'Lubbock') (city) ?	1	1	0	1	1	1	0
3-94529	injuring	city		year	How many people were injured in 2014 (year) in ('Pennsylvania', 'Braddock') (city) ?	1	1	1	0	0	4	1
3-95853	injuring	city		month	How many people were injured in 11/2014 (month) in ('California', 'San Francisco') (city) ?	2	2	2	0	0	10	10
3-94527	injuring	city		year	How many people were injured in 2015 (year) in ('Missouri', 'Kansas City') (city) ?	4	3	1	2	3	5	0
3-89171	killing	city	last		How many people were killed in ('Idaho', 'Meridian') (city) that involve the name Provencio (last) ?	1	0	0	0	1	0	0
3-81207	killing		full_name	year	How many people were killed in 2014 (year) that involve the name German Booker (full_name) ?	2	1	1	0	1	1	0
3-81201	killing		full_name	year	How many people were killed in 2015 (year) that involve the name Gregory Oliver (full_name) ?	2	1	1	0	1	0	0
3-105257	injuring		full_name	day	How many people were injured in 03/06/2016 (day) that involve the name Kyree Greene (full_name) ?	2	0	0	0	2	0	0
3-95863	injuring	city		month	How many people were injured in 12/2016 (month) in ('California', 'Sacramento') (city) ?	4	0	0	0	4	3	0
3-94532	injuring	city		year	How many people were injured in 2016 (year) in ('Texas', 'Beaumont') (city) ?	3	1	1	0	2	2	0
3-93684	injuring	state		day	How many people were injured in 13/09/2014 (day) in ('Virginia',) (state) ?	1	1	1	0	0	1	0
3-94531	injuring	city		year	How many people were injured in 2016 (year) in ('Louisiana', 'Shreveport') (city) ?	4	14	4	10	0	6	16
3-94530	injuring	city		year	How many people were injured in 2015 (year) in ('Georgia', 'Savannah') (city) ?	2	0	0	0	2	4	0
3-93667	injuring	state		day	How many people were injured in 21/02/2016 (day) in ('Idaho',) (state) ?	2	2	2	0	0	1	1
3-94998	injuring	city		year	How many people were injured in 2016 (year) in ('Florida', 'Tampa') (city) ?	2	0	0	0	2	3	0
3-95846	injuring	city		month	How many people were injured in 09/2016 (month) in ('Maryland', 'Baltimore') (city) ?	3	2	2	0	1	11	10
3-93666	injuring	state		day	How many people were injured in 25/10/2015 (day) in ('Arizona',) (state) ?	3	2	2	0	1	5	4
3-94513	injuring	city		year	How many people were injured in 2016 (year) in ('Minnesota', 'Minneapolis') (city) ?	9	9	8	1	1	21	19
3-94997	injuring	city		year	How many people were injured in 2015 (year) in ('California', 'Poway') (city) ?	1	1	1	0	0	1	0
3-93665	injuring	state		day	How many people were injured in 24/09/2016 (day) in ('Louisiana',) (state) ?	1	0	0	0	1	3	0
3-94996	injuring	city		year	How many people were injured in 2016 (year) in ('Indiana', 'Georgetown') (city) ?	2	0	0	0	2	2	0
3-94511	injuring	city		year	How many people were injured in 2016 (year) in ('Virginia', 'Richmond') (city) ?	3	3	1	2	2	3	8
3-95849	injuring	city		month	How many people were injured in 06/2015 (month) in ('Wyoming', 'Cheyenne') (city) ?	1	0	0	0	1	1	0
3-95843	injuring	city		month	How many people were injured in 08/2016 (month) in ('South Carolina', 'Coward') (city) ?	1	0	0	0	1	1	0
3-74921	killing	city		year	How many people were killed in 2015 (year) in ('California', 'San Diego') (city) ?	2	2	2	0	0	3	3
3-94999	injuring	city		year	How many people were injured in 2016 (year) in ('Missouri', 'Saint Louis') (city) ?	6	9	3	6	3	7	14
3-83878	killing		full_name	month	How many people were killed in 11/2016 (month) that involve the name Terrance Goins (full_name) ?	2	1	1	0	1	1	1
3-82549	killing		last	year	How many people were killed in 2015 (year) that involve the name Williams (last) ?	8	15	6	9	2	2	16
3-80369	killing		first	day	How many people were killed in 17/03/2015 (day) that involve the name Aliyah (first) ?	2	1	1	0	1	1	1
3-83876	killing		full_name	month	How many people were killed in 04/2016 (month) that involve the name Bryant Sanchez (full_name) ?	2	1	1	0	1	1	0
3-109474	injuring	city	full_name		How many people were injured in ('Florida', 'Gainesville') (city) that involve the name Antonio Mason (full_name) ?	2	2	2	0	0	0	1
3-94623	injuring	city		year	How many people were injured in 2016 (year) in ('New Jersey', 'Orange') (city) ?	4	0	0	0	4	5	0
3-94622	injuring	city		year	How many people were injured in 2015 (year) in ('Illinois', 'Joliet') (city) ?	2	0	0	0	2	1	0
3-111314	job_firing	city		year	How many people were fired in 2015 (year) in (None, 'Ushiku') (city) ?	1	0	0	0	1	0	0
3-94626	injuring	city		year	How many people were injured in 2016 (year) in ('Florida', 'Miami') (city) ?	13	17	11	6	2	17	21
3-95954	injuring	city		month	How many people were injured in 02/2016 (month) in ('Arizona', 'Phoenix') (city) ?	1	0	0	0	1	1	0
3-93778	injuring	state		day	How many people were injured in 03/08/2015 (day) in ('New York',) (state) ?	4	0	0	0	4	5	0
3-95955	injuring	city		month	How many people were injured in 11/2015 (month) in ('Alabama', 'Birmingham') (city) ?	1	0	0	0	1	1	0
3-83967	killing		full_name	month	How many people were killed in 12/2014 (month) that involve the name Darmequaye Cohill (full_name) ?	1	0	0	0	1	0	0
3-102843	injuring		full_name	month	How many people were injured in 12/2016 (month) that involve the name Ariel Flores (full_name) ?	2	1	1	0	1	0	0
3-81784	killing		last	year	How many people were killed in 2016 (year) that involve the name Davis (last) ?	12	19	11	8	1	4	31
3-82631	killing		last	year	How many people were killed in 2013 (year) that involve the name Montgomery (last) ?	6	0	0	0	6	1	0
3-99083	injuring	city		day	How many people were injured in 18/11/2015 (day) in ('California', 'Fresno') (city) ?	2	0	0	0	2	5	0
3-100661	injuring		first	year	How many people were injured in 2016 (year) that involve the name Marcus (first) ?	6	5	3	2	3	0	11
3-82633	killing		last	year	How many people were killed in 2016 (year) that involve the name Lewis (last) ?	10	5	3	2	7	0	1
3-87090	killing		last	month	How many people were killed in 12/2015 (month) that involve the name Douglas (last) ?	1	1	1	0	0	1	0
3-81308	killing		full_name	year	How many people were killed in 2016 (year) that involve the name Jacob Remaley (full_name) ?	2	2	2	0	0	0	0
3-93784	injuring	state		day	How many people were injured in 28/05/2015 (day) in ('Nebraska',) (state) ?	1	0	0	0	1	4	0
3-94631	injuring	city		year	How many people were injured in 2015 (year) in ('Ohio', 'Cincinnati (Evanston)') (city) ?	3	4	0	4	3	5	0
3-94630	injuring	city		year	How many people were injured in 2015 (year) in ('Rhode Island', 'Woonsocket') (city) ?	2	0	0	0	2	4	0
3-77297	killing	city		month	How many people were killed in 12/2016 (month) in ('California', 'Oakland') (city) ?	1	0	0	0	1	1	0
3-94613	injuring	city		year	How many people were injured in 2016 (year) in ('Virginia', 'Hampton') (city) ?	1	0	0	0	1	1	0
3-94612	injuring	city		year	How many people were injured in 2014 (year) in ('Pennsylvania', 'Pittsburgh') (city) ?	2	2	2	0	0	5	6
3-107281	injuring	city	first		How many people were injured in ('Illinois', 'Chicago') (city) that involve the name Jason (first) ?	1	1	1	0	0	0	0
3-95941	injuring	city		month	How many people were injured in 10/2016 (month) in ('California', 'Fresno') (city) ?	3	1	1	0	2	5	4
3-91105	killing	state	full_name		How many people were killed in ('Oklahoma',) (state) that involve the name Bryon Creech (full_name) ?	1	1	1	0	0	0	0
3-94614	injuring	city		year	How many people were injured in 2014 (year) in ('California', 'Compton') (city) ?	1	2	1	1	0	4	2
3-81320	killing		full_name	year	How many people were killed in 2016 (year) that involve the name Megan Jaronski (full_name) ?	2	1	1	0	1	1	0
3-82652	killing		last	year	How many people were killed in 2016 (year) that involve the name Sanchez (last) ?	4	4	2	2	2	2	4
3-101976	injuring		last	month	How many people were injured in 03/2015 (month) that involve the name Eason (last) ?	2	2	2	0	0	0	4
3-80471	killing		first	day	How many people were killed in 06/09/2016 (day) that involve the name Marqui (first) ?	1	1	1	0	0	1	0
3-79488	killing		first	month	How many people were killed in 01/2013 (month) that involve the name James (first) ?	3	1	0	1	3	0	5
3-99078	injuring	city		day	How many people were injured in 20/02/2016 (day) in ('Florida', 'Orlando') (city) ?	2	0	0	0	2	4	0
3-82649	killing		last	year	How many people were killed in 2016 (year) that involve the name Hall (last) ?	5	7	3	4	2	2	6
3-82642	killing		last	year	How many people were killed in 2015 (year) that involve the name Jones (last) ?	10	13	4	9	6	2	6
3-81797	killing		last	year	How many people were killed in 2015 (year) that involve the name Smith (last) ?	6	15	3	12	3	5	16
3-79482	killing		first	month	How many people were killed in 09/2016 (month) that involve the name Christopher (first) ?	4	5	3	2	1	1	0
3-79485	killing		first	month	How many people were killed in 06/2016 (month) that involve the name Deashaun (first) ?	5	1	1	0	4	0	3
3-91110	killing	state	full_name		How many people were killed in ('New York',) (state) that involve the name John Casullo (full_name) ?	2	0	0	0	2	1	0
3-92440	killing	state	last		How many people were killed in ('Tennessee',) (state) that involve the name Gray (last) ?	2	2	2	0	0	1	0
3-93755	injuring	state		day	How many people were injured in 13/12/2015 (day) in ('California',) (state) ?	3	2	2	0	1	7	7
3-94600	injuring	city		year	How many people were injured in 2016 (year) in ('West Virginia', 'Mannington') (city) ?	1	0	0	0	1	1	0
3-108168	injuring	state	first		How many people were injured in ('Missouri',) (state) that involve the name Paul (first) ?	1	0	0	0	1	0	0
3-94606	injuring	city		year	How many people were injured in 2015 (year) in ('Oklahoma', 'Tulsa') (city) ?	2	2	1	1	1	10	1
3-94604	injuring	city		year	How many people were injured in 2015 (year) in ('California', 'Coachella') (city) ?	1	0	0	0	1	4	0
3-103707	injuring		last	year	How many people were injured in 2016 (year) that involve the name Taylor (last) ?	3	11	1	10	2	1	7
3-94607	injuring	city		year	How many people were injured in 2016 (year) in ('Maryland', 'District Heights (Forestville)') (city) ?	1	1	1	0	0	4	4
3-100678	injuring		first	year	How many people were injured in 2015 (year) that involve the name Marquise (first) ?	6	3	3	0	3	0	13
3-101526	injuring		first	month	How many people were injured in 03/2015 (month) that involve the name Aliyah (first) ?	2	1	1	0	1	0	0
3-103703	injuring		last	year	How many people were injured in 2015 (year) that involve the name Wallace (last) ?	4	3	3	0	1	1	7
3-101527	injuring		first	month	How many people were injured in 02/2016 (month) that involve the name Jerrod (first) ?	3	1	1	0	2	0	3
3-101532	injuring		first	month	How many people were injured in 10/2016 (month) that involve the name Luis (first) ?	4	4	0	4	4	1	0
3-80432	killing		first	day	How many people were killed in 06/12/2014 (day) that involve the name Riley (first) ?	1	0	0	0	1	0	0
3-80431	killing		first	day	How many people were killed in 01/06/2014 (day) that involve the name Miranda (first) ?	2	0	0	0	2	1	0
3-100681	injuring		first	year	How many people were injured in 2015 (year) that involve the name Cameron (first) ?	3	6	2	4	1	1	8
3-75094	killing	city		year	How many people were killed in 2016 (year) in ('Louisiana', 'Monroe') (city) ?	3	0	0	0	3	2	0
3-75092	killing	city		year	How many people were killed in 2016 (year) in ('Pennsylvania', 'New Stanton') (city) ?	2	0	0	0	2	2	0
3-99063	injuring	city		day	How many people were injured in 05/11/2016 (day) in ('California', 'Oakland') (city) ?	4	0	0	0	4	8	0
3-75091	killing	city		year	How many people were killed in 2015 (year) in ('Tennessee', 'Nashville') (city) ?	2	1	1	0	1	2	1
3-79452	killing		first	month	How many people were killed in 10/2016 (month) that involve the name William (first) ?	5	2	2	0	3	1	1
3-109000	injuring	state	last		How many people were injured in ('Ohio',) (state) that involve the name Wells (last) ?	1	1	1	0	0	0	3
3-93742	injuring	state		day	How many people were injured in 10/11/2016 (day) in ('Texas',) (state) ?	1	1	1	0	0	3	1
3-108158	injuring	state	first		How many people were injured in ('New York',) (state) that involve the name Michael (first) ?	3	0	0	0	3	0	0
3-95920	injuring	city		month	How many people were injured in 11/2016 (month) in ('Texas', 'Houston') (city) ?	6	3	3	0	3	9	7
3-92898	killing	state	last		How many people were killed in ('New York',) (state) that involve the name Lewis (last) ?	4	0	0	0	4	0	0
3-93746	injuring	state		day	How many people were injured in 19/05/2016 (day) in ('Illinois',) (state) ?	1	0	0	0	1	1	0
3-81777	killing		last	year	How many people were killed in 2016 (year) that involve the name Coleman (last) ?	4	3	2	1	2	1	6
3-102852	injuring		full_name	month	How many people were injured in 11/2014 (month) that involve the name Suze Sadler (full_name) ?	1	1	1	0	0	0	0
3-100676	injuring		first	year	How many people were injured in 2015 (year) that involve the name Pamela (first) ?	4	3	3	0	1	2	4
3-80443	killing		first	day	How many people were killed in 03/09/2016 (day) that involve the name Wakeel (first) ?	2	0	0	0	2	0	0
3-99051	injuring	city		day	How many people were injured in 21/04/2016 (day) in ('Maryland', 'Baltimore') (city) ?	1	0	0	0	1	4	0
3-111318	job_firing	city		year	How many people were fired in 2015 (year) in (None, 'Grapevine') (city) ?	1	0	0	0	1	0	0
3-99058	injuring	city		day	How many people were injured in 13/04/2016 (day) in ('Kansas', 'Wichita') (city) ?	1	0	0	0	1	2	0
3-93733	injuring	state		day	How many people were injured in 05/11/2014 (day) in ('California',) (state) ?	1	1	1	0	0	4	4
3-88385	killing	state	first		How many people were killed in ('New York',) (state) that involve the name John (first) ?	8	0	0	0	8	1	0
3-87052	killing		last	month	How many people were killed in 08/2014 (month) that involve the name Hills (last) ?	1	1	1	0	0	1	0
3-87051	killing		last	month	How many people were killed in 07/2013 (month) that involve the name Wright (last) ?	3	2	2	0	1	0	2
3-95910	injuring	city		month	How many people were injured in 09/2016 (month) in ('Pennsylvania', 'Pittsburgh') (city) ?	2	5	1	4	1	4	9
3-109439	injuring	city	full_name		How many people were injured in ('Michigan', 'Detroit') (city) that involve the name Zanyrah Taylor (full_name) ?	1	2	1	1	0	1	0
3-100620	injuring		first	year	How many people were injured in 2016 (year) that involve the name Desmond (first) ?	1	3	1	2	0	1	4
3-99042	injuring	city		day	How many people were injured in 08/03/2016 (day) in ('Florida', 'Largo') (city) ?	1	1	1	0	0	1	0
3-102800	injuring		full_name	month	How many people were injured in 10/2016 (month) that involve the name James Coward (full_name) ?	2	0	0	0	2	0	0
3-81741	killing		full_name	year	How many people were killed in 2016 (year) that involve the name Eulalio Tordil (full_name) ?	1	1	1	0	0	0	1
3-98191	injuring	state		month	How many people were injured in 06/2015 (month) in ('New York',) (state) ?	8	0	0	0	8	18	0
3-75070	killing	city		year	How many people were killed in 2016 (year) in ('Alabama', 'Montgomery') (city) ?	2	0	0	0	2	3	0
3-98194	injuring	state		month	How many people were injured in 12/2016 (month) in ('Alabama',) (state) ?	3	1	1	0	2	9	4
3-98193	injuring	state		month	How many people were injured in 07/2016 (month) in ('Pennsylvania',) (state) ?	12	8	5	3	7	7	19
3-98199	injuring	state		month	How many people were injured in 08/2016 (month) in ('Connecticut',) (state) ?	10	6	6	0	4	21	14
3-87066	killing		last	month	How many people were killed in 01/2015 (month) that involve the name Wiederholt (last) ?	2	1	1	0	1	1	0
3-92875	killing	state	last		How many people were killed in ('Indiana',) (state) that involve the name Griffith (last) ?	2	2	2	0	0	1	0
3-95903	injuring	city		month	How many people were injured in 04/2016 (month) in ('South Carolina', 'Bluffton') (city) ?	1	0	0	0	1	1	0
3-95906	injuring	city		month	How many people were injured in 12/2016 (month) in ('North Carolina', 'Rocky Mount') (city) ?	1	0	0	0	1	4	0
3-95907	injuring	city		month	How many people were injured in 03/2013 (month) in ('New York', 'Mohawk') (city) ?	3	0	0	0	3	2	0
3-81755	killing		full_name	year	How many people were killed in 2014 (year) that involve the name Dearn Marcano (full_name) ?	1	1	1	0	0	1	1
3-82604	killing		last	year	How many people were killed in 2016 (year) that involve the name Andrews (last) ?	3	4	3	1	0	1	8
3-83932	killing		full_name	month	How many people were killed in 06/2016 (month) that involve the name Christopher Lassiter (full_name) ?	3	3	3	0	0	1	0
3-105067	injuring		full_name	day	How many people were injured in 05/11/2016 (day) that involve the name Pontus Adams (full_name) ?	1	1	1	0	0	0	3
3-77260	killing	city		month	How many people were killed in 07/2015 (month) in ('Texas', 'Fresno') (city) ?	1	0	0	0	1	1	0
3-77262	killing	city		month	How many people were killed in 01/2016 (month) in ('Maryland', 'Baltimore') (city) ?	1	1	1	0	0	1	0
3-82606	killing		last	year	How many people were killed in 2016 (year) that involve the name Dixon (last) ?	3	4	2	2	1	0	7
3-92882	killing	state	last		How many people were killed in ('South Carolina',) (state) that involve the name Burroughs (last) ?	1	0	0	0	1	2	0
3-98188	injuring	state		month	How many people were injured in 09/2016 (month) in ('North Carolina',) (state) ?	4	5	4	1	0	9	11
3-99038	injuring	city		day	How many people were injured in 11/07/2016 (day) in ('Maryland', 'Baltimore') (city) ?	2	0	0	0	2	5	0
3-77265	killing	city		month	How many people were killed in 07/2016 (month) in ('New York', 'Elmira') (city) ?	1	0	0	0	1	1	0
3-86185	killing		first	year	How many people were killed in 2016 (year) that involve the name Derrius (first) ?	8	3	3	0	5	2	5
3-88363	killing	state	first		How many people were killed in ('North Dakota',) (state) that involve the name Boyd (first) ?	1	0	0	0	1	0	0
3-92862	killing	state	last		How many people were killed in ('Florida',) (state) that involve the name Eason (last) ?	2	2	2	0	0	1	11
3-92867	killing	state	last		How many people were killed in ('New Jersey',) (state) that involve the name Sexton (last) ?	2	1	1	0	1	1	0
3-92869	killing	state	last		How many people were killed in ('Illinois',) (state) that involve the name Jackson (last) ?	4	6	2	4	2	1	9
3-100636	injuring		first	year	How many people were injured in 2016 (year) that involve the name Eric (first) ?	9	26	3	23	6	2	43
3-77233	killing	city		month	How many people were killed in 10/2016 (month) in ('Texas', 'San Angelo') (city) ?	1	1	1	0	0	1	1
3-100643	injuring		first	year	How many people were injured in 2016 (year) that involve the name Antonio (first) ?	5	7	4	3	1	0	2
3-77238	killing	city		month	How many people were killed in 01/2013 (month) in ('Oklahoma', 'Tulsa') (city) ?	3	1	1	0	2	4	4
3-77232	killing	city		month	How many people were killed in 08/2015 (month) in ('Ohio', 'Cincinnati') (city) ?	2	0	0	0	2	2	0
3-99026	injuring	city		day	How many people were injured in 17/10/2016 (day) in ('Illinois', 'Chicago (Englewood)') (city) ?	2	2	2	0	0	4	4
3-105082	injuring		full_name	day	How many people were injured in 19/04/2016 (day) that involve the name Damond Dawson (full_name) ?	2	2	2	0	0	0	4
3-91524	killing	city	first		How many people were killed in ('Illinois', 'Rock Falls') (city) that involve the name Brady (first) ?	3	0	0	0	3	0	0
3-93707	injuring	state		day	How many people were injured in 09/08/2015 (day) in ('Michigan',) (state) ?	2	0	0	0	2	3	0
3-100629	injuring		first	year	How many people were injured in 2015 (year) that involve the name Jamie (first) ?	3	5	3	2	0	2	8
3-87046	killing		last	month	How many people were killed in 07/2016 (month) that involve the name Rodriguez (last) ?	4	5	4	1	0	3	5
3-75065	killing	city		year	How many people were killed in 2015 (year) in ('New Mexico', 'Rio Rancho') (city) ?	1	1	1	0	0	2	0
3-76398	killing	state		month	How many people were killed in 04/2016 (month) in ('Kansas',) (state) ?	3	1	1	0	2	2	1
3-75062	killing	city		year	How many people were killed in 2016 (year) in ('Indiana', 'Indianapolis') (city) ?	21	14	11	3	10	10	15
3-81736	killing		full_name	year	How many people were killed in 2016 (year) that involve the name Miles Heizer (full_name) ?	2	1	1	0	1	0	0
3-99011	injuring	city		day	How many people were injured in 14/05/2016 (day) in ('Louisiana', 'Baton Rouge') (city) ?	2	1	1	0	1	1	0
3-75060	killing	city		year	How many people were killed in 2016 (year) in ('Illinois', 'Rockford') (city) ?	3	0	0	0	3	2	0
3-80887	killing		full_name	year	How many people were killed in 2013 (year) that involve the name Joezell Williams (full_name) ?	2	1	1	0	1	1	3
3-99492	injuring	city		day	How many people were injured in 27/09/2014 (day) in ('Missouri', 'Saint Louis') (city) ?	1	0	0	0	1	5	0
3-99491	injuring	city		day	How many people were injured in 16/07/2016 (day) in ('Texas', 'Dallas') (city) ?	1	0	0	0	1	5	0
3-99018	injuring	city		day	How many people were injured in 29/11/2013 (day) in ('Indiana', 'Indianapolis') (city) ?	2	0	0	0	2	4	0
3-107268	injuring	city	first		How many people were injured in ('Texas', 'Dallas') (city) that involve the name Adriana (first) ?	3	0	0	0	3	1	0
3-76390	killing	state		month	How many people were killed in 11/2016 (month) in ('Texas',) (state) ?	9	9	7	2	2	9	11
3-99019	injuring	city		day	How many people were injured in 12/02/2014 (day) in ('California', 'Stockton') (city) ?	1	1	1	0	0	3	4
3-99016	injuring	city		day	How many people were injured in 10/06/2016 (day) in ('California', 'Los Angeles (Boyle Heights)') (city) ?	1	1	1	0	0	1	0
3-75066	killing	city		year	How many people were killed in 2016 (year) in ('Washington', 'Burlington') (city) ?	5	2	2	0	3	5	9
3-98168	injuring	state		month	How many people were injured in 03/2015 (month) in ('California',) (state) ?	4	4	2	2	2	12	8
3-109079	injuring	city	full_name		How many people were injured in ('Georgia', 'Dallas') (city) that involve the name Quincy Lynch (full_name) ?	2	0	0	0	2	0	0
3-86161	killing		first	year	How many people were killed in 2016 (year) that involve the name Bryant (first) ?	3	2	1	1	2	1	2
3-90663	killing	state	full_name		How many people were killed in ('Kentucky',) (state) that involve the name Desean Mitchell (full_name) ?	1	1	1	0	0	1	2
3-90665	killing	state	full_name		How many people were killed in ('Indiana',) (state) that involve the name Matthew Kendall (full_name) ?	3	1	1	0	2	1	0
3-87018	killing		last	month	How many people were killed in 12/2016 (month) that involve the name Johnson (last) ?	13	7	7	0	6	3	4
3-104619	injuring		full_name	year	How many people were injured in 2015 (year) that involve the name Chanell Berry (full_name) ?	3	1	1	0	2	0	1
3-87013	killing		last	month	How many people were killed in 06/2016 (month) that involve the name Jones (last) ?	8	2	2	0	6	1	1
3-74185	killing	state		year	How many people were killed in 2016 (year) in ('Hawaii',) (state) ?	5	4	4	0	1	3	0
3-103779	injuring		last	year	How many people were injured in 2013 (year) that involve the name Ward (last) ?	7	3	3	0	4	1	6
3-74184	killing	state		year	How many people were killed in 2016 (year) in ('Alaska',) (state) ?	5	5	5	0	0	5	11
3-100269	injuring		first	year	How many people were injured in 2016 (year) that involve the name Andrew (first) ?	3	19	3	16	0	1	18
3-74183	killing	state		year	How many people were killed in 2013 (year) in ('New York',) (state) ?	9	0	0	0	9	8	0
3-77697	killing	city		month	How many people were killed in 09/2016 (month) in ('Hawaii', 'Kahuku') (city) ?	3	1	1	0	2	2	0
3-80850	killing		full_name	year	How many people were killed in 2015 (year) that involve the name Ryan Korish (full_name) ?	2	0	0	0	2	0	0
3-98154	injuring	state		month	How many people were injured in 11/2016 (month) in ('Florida',) (state) ?	6	7	6	1	0	9	12
3-99485	injuring	city		day	How many people were injured in 01/01/2016 (day) in ('Nevada', 'Las Vegas') (city) ?	1	1	1	0	0	1	1
3-74181	killing	state		year	How many people were killed in 2015 (year) in ('Washington',) (state) ?	4	8	3	5	1	3	1
3-74180	killing	state		year	How many people were killed in 2015 (year) in ('Texas',) (state) ?	29	34	19	15	10	22	36
3-87009	killing		last	month	How many people were killed in 09/2016 (month) that involve the name Green (last) ?	7	6	5	1	2	0	11
3-100266	injuring		first	year	How many people were injured in 2014 (year) that involve the name Gabriel (first) ?	3	3	3	0	0	2	9
3-103770	injuring		last	year	How many people were injured in 2013 (year) that involve the name Jones (last) ?	7	9	5	4	2	0	16
3-99007	injuring	city		day	How many people were injured in 04/10/2016 (day) in ('Tennessee', 'Nashville') (city) ?	1	1	1	0	0	1	0
3-99009	injuring	city		day	How many people were injured in 28/07/2016 (day) in ('New York', 'Elmira') (city) ?	3	0	0	0	3	5	0
3-74189	killing	state		year	How many people were killed in 2015 (year) in ('Mississippi',) (state) ?	4	2	1	1	3	3	3
3-74188	killing	state		year	How many people were killed in 2016 (year) in ('Texas',) (state) ?	97	95	67	28	30	60	100
3-74187	killing	state		year	How many people were killed in 2015 (year) in ('Arizona',) (state) ?	8	6	6	0	2	12	7
3-99488	injuring	city		day	How many people were injured in 10/04/2016 (day) in ('Wisconsin', 'Milwaukee') (city) ?	1	1	1	0	0	3	3
3-90656	killing	state	full_name		How many people were killed in ('Missouri',) (state) that involve the name Marcus Lyman (full_name) ?	2	1	1	0	1	1	3
3-86178	killing		first	year	How many people were killed in 2016 (year) that involve the name Donald (first) ?	9	4	2	2	7	1	0
3-74196	killing	state		year	How many people were killed in 2015 (year) in ('Louisiana',) (state) ?	14	18	13	5	1	13	8
3-104615	injuring		full_name	year	How many people were injured in 2016 (year) that involve the name Daquarius Tucker (full_name) ?	5	2	2	0	3	0	3
3-105945	injuring		last	day	How many people were injured in 26/08/2015 (day) that involve the name Davis (last) ?	3	2	2	0	1	0	4
3-74195	killing	state		year	How many people were killed in 2013 (year) in ('Illinois',) (state) ?	10	6	2	4	8	7	7
3-75042	killing	city		year	How many people were killed in 2013 (year) in ('California', 'Hawthorne') (city) ?	1	0	0	0	1	1	0
3-98140	injuring	state		month	How many people were injured in 10/2015 (month) in ('Arizona',) (state) ?	5	4	4	0	1	8	7
3-100258	injuring		first	year	How many people were injured in 2013 (year) that involve the name Marcus (first) ?	2	1	1	0	1	0	2
3-74194	killing	state		year	How many people were killed in 2015 (year) in ('North Carolina',) (state) ?	5	8	5	3	0	6	10
3-103766	injuring		last	year	How many people were injured in 2016 (year) that involve the name Adams (last) ?	5	14	1	13	4	1	27
3-105943	injuring		last	day	How many people were injured in 09/07/2013 (day) that involve the name Jones (last) ?	2	0	0	0	2	0	0
3-77225	killing	city		month	How many people were killed in 06/2015 (month) in ('Montana', 'Saint Marie') (city) ?	1	0	0	0	1	1	0
3-77226	killing	city		month	How many people were killed in 01/2016 (month) in ('Georgia', 'Buford') (city) ?	1	0	0	0	1	2	0
3-74191	killing	state		year	How many people were killed in 2014 (year) in ('Colorado',) (state) ?	6	3	3	0	3	3	2
3-103761	injuring		last	year	How many people were injured in 2015 (year) that involve the name Sanders (last) ?	5	3	2	1	3	0	5
3-99479	injuring	city		day	How many people were injured in 14/06/2016 (day) in ('Delaware', 'Wilmington') (city) ?	2	0	0	0	2	4	0
3-100250	injuring		first	year	How many people were injured in 2016 (year) that involve the name Gregory (first) ?	7	8	5	3	2	0	7
3-75047	killing	city		year	How many people were killed in 2013 (year) in ('Oklahoma', 'Tulsa') (city) ?	5	5	5	0	0	5	8
3-98144	injuring	state		month	How many people were injured in 08/2015 (month) in ('Tennessee',) (state) ?	3	3	3	0	0	5	6
3-74198	killing	state		year	How many people were killed in 2015 (year) in ('Massachusetts',) (state) ?	3	2	0	2	3	2	1
3-74197	killing	state		year	How many people were killed in 2016 (year) in ('Maryland',) (state) ?	15	22	11	11	4	10	29
3-92823	killing	state	last		How many people were killed in ('Louisiana',) (state) that involve the name Williams (last) ?	4	2	2	0	2	1	1
3-75008	killing	city		year	How many people were killed in 2016 (year) in ('Florida', 'Miami Gardens') (city) ?	3	2	2	0	1	3	2
3-110080	injuring	city	last		How many people were injured in ('Illinois', 'Calumet City') (city) that involve the name Purnell (last) ?	2	2	2	0	0	0	8
3-105979	injuring		last	day	How many people were injured in 05/08/2016 (day) that involve the name Edwards (last) ?	3	2	2	0	1	0	3
3-74163	killing	state		year	How many people were killed in 2015 (year) in ('Pennsylvania',) (state) ?	13	15	7	8	6	8	7
3-75010	killing	city		year	How many people were killed in 2016 (year) in ('Nevada', 'Las Vegas') (city) ?	10	7	7	0	3	3	2
3-76343	killing	state		month	How many people were killed in 04/2016 (month) in ('Wisconsin',) (state) ?	5	5	5	0	0	6	2
3-74161	killing	state		year	How many people were killed in 2014 (year) in ('Pennsylvania',) (state) ?	4	4	3	1	1	3	4
3-103315	injuring		last	year	How many people were injured in 2015 (year) that involve the name Cochran (last) ?	2	2	2	0	0	0	2
3-103799	injuring		last	year	How many people were injured in 2015 (year) that involve the name Berry (last) ?	5	5	2	3	3	0	4
3-74169	killing	state		year	How many people were killed in 2013 (year) in ('California',) (state) ?	19	15	15	0	4	16	19
3-74168	killing	state		year	How many people were killed in 2016 (year) in ('Arkansas',) (state) ?	23	23	14	9	9	12	16
3-75015	killing	city		year	How many people were killed in 2014 (year) in ('Colorado', 'Yuma') (city) ?	2	0	0	0	2	1	0
3-98134	injuring	state		month	How many people were injured in 01/2016 (month) in ('Illinois',) (state) ?	2	0	0	0	2	2	0
3-98135	injuring	state		month	How many people were injured in 09/2016 (month) in ('Michigan',) (state) ?	9	7	7	0	2	6	13
3-92813	killing	state	last		How many people were killed in ('Illinois',) (state) that involve the name Jacob (last) ?	1	0	0	0	1	1	0
3-86158	killing		first	year	How many people were killed in 2016 (year) that involve the name Owen (first) ?	4	4	3	1	1	2	4
3-106809	injuring		first	day	How many people were injured in 18/07/2015 (day) that involve the name Eric (first) ?	1	1	1	0	0	0	0
3-106807	injuring		first	day	How many people were injured in 20/09/2015 (day) that involve the name LaBrian (first) ?	2	2	2	0	0	0	3
3-110074	injuring	city	last		How many people were injured in ('Rhode Island', 'Woonsocket') (city) that involve the name Alvarado (last) ?	2	1	1	0	1	0	4
3-102457	injuring		last	month	How many people were injured in 12/2016 (month) that involve the name Francis (last) ?	1	1	1	0	0	0	0
3-103789	injuring		last	year	How many people were injured in 2015 (year) that involve the name Jones (last) ?	15	13	6	7	9	3	30
3-74174	killing	state		year	How many people were killed in 2016 (year) in ('Mississippi',) (state) ?	6	4	1	3	5	4	2
3-95092	injuring	city		year	How many people were injured in 2015 (year) in ('New York', 'New York (Manhattan)') (city) ?	5	8	2	6	3	8	14
3-99450	injuring	city		day	How many people were injured in 15/12/2013 (day) in ('Florida', 'Homestead (Florida City)') (city) ?	2	0	0	0	2	3	0
3-104637	injuring		full_name	year	How many people were injured in 2013 (year) that involve the name William Monroe (full_name) ?	3	2	2	0	1	0	6
3-74173	killing	state		year	How many people were killed in 2014 (year) in ('Wisconsin',) (state) ?	2	2	1	1	1	2	2
3-75020	killing	city		year	How many people were killed in 2013 (year) in ('Indiana', 'Gary') (city) ?	3	0	0	0	3	2	0
3-74172	killing	state		year	How many people were killed in 2016 (year) in ('New York',) (state) ?	32	5	5	0	27	17	8
3-79865	killing		first	day	How many people were killed in 07/11/2016 (day) that involve the name Jarius (first) ?	1	1	1	0	0	1	1
3-103788	injuring		last	year	How many people were injured in 2016 (year) that involve the name Thomas (last) ?	3	19	3	16	0	0	39
3-74171	killing	state		year	How many people were killed in 2015 (year) in ('Ohio',) (state) ?	19	12	7	5	12	11	8
3-74170	killing	state		year	How many people were killed in 2013 (year) in ('Kentucky',) (state) ?	2	2	2	0	0	3	2
3-76358	killing	state		month	How many people were killed in 03/2015 (month) in ('Florida',) (state) ?	4	4	4	0	0	3	14
3-104630	injuring		full_name	year	How many people were injured in 2016 (year) that involve the name Stephon Harris (full_name) ?	3	0	0	0	3	0	0
3-103300	injuring		last	year	How many people were injured in 2016 (year) that involve the name Tewalt (last) ?	1	1	1	0	0	1	1
3-103781	injuring		last	year	How many people were injured in 2013 (year) that involve the name Robinson (last) ?	5	7	4	3	1	1	19
3-95099	injuring	city		year	How many people were injured in 2016 (year) in ('Idaho', 'Idaho Falls') (city) ?	1	0	0	0	1	1	0
3-102451	injuring		last	month	How many people were injured in 10/2016 (month) that involve the name Brown (last) ?	7	7	4	3	3	2	28
3-74179	killing	state		year	How many people were killed in 2016 (year) in ('South Carolina',) (state) ?	15	16	9	7	6	16	13
3-99459	injuring	city		day	How many people were injured in 05/07/2014 (day) in ('Texas', 'Houston') (city) ?	1	1	0	1	1	6	0
3-75025	killing	city		year	How many people were killed in 2014 (year) in ('Oklahoma', 'Midwest City') (city) ?	1	1	1	0	0	1	1
3-74176	killing	state		year	How many people were killed in 2015 (year) in ('Tennessee',) (state) ?	15	10	8	2	7	9	12
3-74175	killing	state		year	How many people were killed in 2015 (year) in ('Colorado',) (state) ?	4	3	3	0	1	2	2
3-87451	killing		last	month	How many people were killed in 06/2016 (month) that involve the name Powell (last) ?	1	1	1	0	0	2	2
3-74139	killing	state		year	How many people were killed in 2016 (year) in ('Virginia',) (state) ?	9	4	3	1	6	10	4
3-88306	killing	state	first		How many people were killed in ('Ohio',) (state) that involve the name Tyanna (first) ?	2	0	0	0	2	0	0
3-88303	killing	state	first		How many people were killed in ('Massachusetts',) (state) that involve the name Alex (first) ?	2	0	0	0	2	1	0
3-103727	injuring		last	year	How many people were injured in 2015 (year) that involve the name Williams (last) ?	7	17	5	12	2	2	25
3-87454	killing		last	month	How many people were killed in 07/2016 (month) that involve the name Alexander (last) ?	1	0	0	0	1	1	0
3-92809	killing	state	last		How many people were killed in ('Florida',) (state) that involve the name Edwards (last) ?	1	1	1	0	0	0	0
3-100219	injuring		first	year	How many people were injured in 2016 (year) that involve the name Owen (first) ?	2	7	1	6	1	0	8
3-74141	killing	state		year	How many people were killed in 2013 (year) in ('Tennessee',) (state) ?	6	4	4	0	2	5	6
3-100224	injuring		first	year	How many people were injured in 2016 (year) that involve the name John (first) ?	4	37	4	33	0	0	27
3-95080	injuring	city		year	How many people were injured in 2016 (year) in ('Arkansas', 'Eudora') (city) ?	1	1	1	0	0	2	3
3-100226	injuring		first	year	How many people were injured in 2016 (year) that involve the name Roy (first) ?	3	4	3	1	0	0	6
3-76324	killing	state		month	How many people were killed in 11/2016 (month) in ('Delaware',) (state) ?	2	1	1	0	1	1	0
3-95084	injuring	city		year	How many people were injured in 2014 (year) in ('Indiana', 'Franklin') (city) ?	1	0	0	0	1	2	0
3-98116	injuring	state		month	How many people were injured in 04/2015 (month) in ('New York',) (state) ?	3	0	0	0	3	4	0
3-74148	killing	state		year	How many people were killed in 2016 (year) in ('Ohio',) (state) ?	32	31	19	12	13	20	38
3-98596	injuring	state		month	How many people were injured in 07/2015 (month) in ('Kentucky',) (state) ?	7	7	6	1	1	11	22
3-99443	injuring	city		day	How many people were injured in 29/04/2016 (day) in ('Tennessee', 'Lebanon') (city) ?	2	0	0	0	2	1	0
3-98111	injuring	state		month	How many people were injured in 10/2016 (month) in ('Minnesota',) (state) ?	2	2	2	0	0	4	1
3-98595	injuring	state		month	How many people were injured in 05/2015 (month) in ('Alabama',) (state) ?	1	1	1	0	0	3	4
3-74142	killing	state		year	How many people were killed in 2015 (year) in ('Virginia',) (state) ?	5	3	3	0	2	2	1
3-98113	injuring	state		month	How many people were injured in 06/2014 (month) in ('New York',) (state) ?	1	0	0	0	1	4	0
3-110016	injuring	city	last		How many people were injured in ('California', 'San Francisco') (city) that involve the name Smith (last) ?	2	2	2	0	0	0	4
3-103718	injuring		last	year	How many people were injured in 2014 (year) that involve the name Davila (last) ?	1	1	1	0	0	2	6
3-87463	killing		last	month	How many people were killed in 11/2015 (month) that involve the name Taylor (last) ?	2	2	2	0	0	1	4
3-86133	killing		first	year	How many people were killed in 2016 (year) that involve the name Edwin (first) ?	4	3	2	1	2	2	2
3-87464	killing		last	month	How many people were killed in 07/2015 (month) that involve the name Vogt (last) ?	1	1	1	0	0	0	0
3-100212	injuring		first	year	How many people were injured in 2015 (year) that involve the name Ronald (first) ?	3	4	2	2	1	0	13
3-74152	killing	state		year	How many people were killed in 2013 (year) in ('Florida',) (state) ?	6	7	5	2	1	4	10
3-76331	killing	state		month	How many people were killed in 10/2016 (month) in ('Georgia',) (state) ?	6	4	4	0	2	7	5
3-77662	killing	city		month	How many people were killed in 04/2016 (month) in ('Illinois', 'Chicago (Englewood)') (city) ?	1	1	0	1	1	2	4
3-75482	killing	city		day	How many people were killed in 22/05/2016 (day) in ('California', 'Stockton') (city) ?	1	0	0	0	1	1	0
3-76332	killing	state		month	How many people were killed in 01/2015 (month) in ('California',) (state) ?	7	7	7	0	0	11	12
3-101545	injuring		first	month	How many people were injured in 11/2016 (month) that involve the name Christopher (first) ?	3	5	3	2	0	0	8
3-98582	injuring	state		month	How many people were injured in 05/2015 (month) in ('Ohio',) (state) ?	6	4	3	1	3	12	6
3-76335	killing	state		month	How many people were killed in 03/2015 (month) in ('Oklahoma',) (state) ?	4	1	1	0	3	2	1
3-98105	injuring	state		month	How many people were injured in 10/2016 (month) in ('Kansas',) (state) ?	1	2	1	1	0	1	0
3-74158	killing	state		year	How many people were killed in 2016 (year) in ('West Virginia',) (state) ?	4	4	3	1	1	2	1
3-75005	killing	city		year	How many people were killed in 2013 (year) in ('California', 'Vallejo') (city) ?	6	2	2	0	4	4	1
3-74157	killing	state		year	How many people were killed in 2016 (year) in ('Louisiana',) (state) ?	27	33	22	11	5	17	30
3-95075	injuring	city		year	How many people were injured in 2015 (year) in ('Florida', 'Miami') (city) ?	4	8	4	4	0	5	19
3-74155	killing	state		year	How many people were killed in 2015 (year) in ('Minnesota',) (state) ?	1	0	0	0	1	1	0
3-98584	injuring	state		month	How many people were injured in 06/2015 (month) in ('Michigan',) (state) ?	5	3	1	2	4	17	2
3-99431	injuring	city		day	How many people were injured in 13/06/2016 (day) in ('California', 'Fresno') (city) ?	1	1	1	0	0	4	2
3-74154	killing	state		year	How many people were killed in 2013 (year) in ('New Jersey',) (state) ?	3	1	1	0	2	2	1
3-75485	killing	city		day	How many people were killed in 03/06/2014 (day) in ('Georgia', 'Atlanta') (city) ?	2	2	2	0	0	1	1
3-99434	injuring	city		day	How many people were injured in 30/11/2013 (day) in ('Michigan', 'Lansing') (city) ?	1	1	1	0	0	5	5
3-95079	injuring	city		year	How many people were injured in 2015 (year) in ('Arkansas', 'Little Rock') (city) ?	3	8	3	5	0	4	8
3-98586	injuring	state		month	How many people were injured in 08/2015 (month) in ('New York',) (state) ?	5	0	0	0	5	8	0
3-111373	job_firing	state		year	How many people were fired in 2015 (year) in ('Colorado',) (state) ?	1	0	0	0	1	2	0
3-74117	killing	state		year	How many people were killed in 2016 (year) in ('Arizona',) (state) ?	4	4	2	2	2	5	3
3-99419	injuring	city		day	How many people were injured in 21/02/2013 (day) in ('Oklahoma', 'Tulsa') (city) ?	2	2	2	0	0	3	1
3-79805	killing		first	day	How many people were killed in 11/07/2014 (day) that involve the name Damien (first) ?	1	1	1	0	0	1	2
3-86589	killing		first	year	How many people were killed in 2016 (year) that involve the name George (first) ?	7	14	5	9	2	1	10
3-87436	killing		last	month	How many people were killed in 09/2015 (month) that involve the name Pohto (last) ?	3	1	1	0	2	0	0
3-86587	killing		first	year	How many people were killed in 2015 (year) that involve the name Karen (first) ?	1	4	1	3	0	1	7
3-86101	killing		first	year	How many people were killed in 2016 (year) that involve the name Travon (first) ?	11	4	4	0	7	1	2
3-102418	injuring		last	month	How many people were injured in 04/2016 (month) that involve the name Cole (last) ?	1	2	1	1	0	0	3
3-103756	injuring		last	year	How many people were injured in 2015 (year) that involve the name Callahan (last) ?	4	2	1	1	3	1	11
3-100248	injuring		first	year	How many people were injured in 2016 (year) that involve the name Stephon (first) ?	4	1	1	0	3	0	4
3-89609	killing	city	full_name		How many people were killed in ('Ohio', 'Cincinnati') (city) that involve the name Georta Mack (full_name) ?	1	0	0	0	1	1	0
3-95063	injuring	city		year	How many people were injured in 2016 (year) in ('Arizona', 'Phoenix') (city) ?	4	6	2	4	2	9	4
3-95061	injuring	city		year	How many people were injured in 2015 (year) in ('North Carolina', 'Rocky Mount') (city) ?	1	0	0	0	1	4	0
3-95067	injuring	city		year	How many people were injured in 2015 (year) in ('Alabama', 'Montgomery') (city) ?	2	0	0	0	2	8	0
3-74126	killing	state		year	How many people were killed in 2015 (year) in ('Maryland',) (state) ?	6	8	4	4	2	8	13
3-95066	injuring	city		year	How many people were injured in 2016 (year) in ('Maine', 'New Sharon') (city) ?	1	0	0	0	1	1	0
3-98579	injuring	state		month	How many people were injured in 06/2016 (month) in ('Michigan',) (state) ?	2	3	1	2	1	2	5
3-74123	killing	state		year	How many people were killed in 2016 (year) in ('Oregon',) (state) ?	4	3	3	0	1	4	7
3-74121	killing	state		year	How many people were killed in 2016 (year) in ('Washington',) (state) ?	15	14	6	8	9	9	14
3-111365	job_firing	state		year	How many people were fired in 2015 (year) in ('Mississippi',) (state) ?	2	1	0	1	2	0	0
3-111368	job_firing	state		year	How many people were fired in 2015 (year) in ('Arizona',) (state) ?	2	1	1	0	1	2	1
3-74128	killing	state		year	How many people were killed in 2016 (year) in ('Pennsylvania',) (state) ?	41	44	32	12	9	25	40
3-86116	killing		first	year	How many people were killed in 2015 (year) that involve the name Corey (first) ?	7	5	2	3	5	1	4
3-78968	killing		first	month	How many people were killed in 11/2016 (month) that involve the name Christopher (first) ?	2	3	2	1	0	2	2
3-103738	injuring		last	year	How many people were injured in 2014 (year) that involve the name Tomman (last) ?	2	2	2	0	0	0	6
3-111360	job_firing	state		year	How many people were fired in 2015 (year) in ('Florida',) (state) ?	6	0	0	0	6	1	0
3-75461	killing	city		day	How many people were killed in 05/06/2014 (day) in ('Utah', 'Salt Lake City (Cottonwood Heights)') (city) ?	1	0	0	0	1	1	0
3-77640	killing	city		month	How many people were killed in 12/2016 (month) in ('Alabama', 'Birmingham') (city) ?	1	0	0	0	1	1	0
3-96380	injuring	city		month	How many people were injured in 12/2015 (month) in ('Alabama', 'Mobile') (city) ?	1	0	0	0	1	4	0
3-102412	injuring		last	month	How many people were injured in 08/2016 (month) that involve the name Pineda (last) ?	1	1	1	0	0	0	5
3-76794	killing	state		day	How many people were killed in 28/06/2016 (day) in ('Texas',) (state) ?	6	6	6	0	0	4	7
3-77641	killing	city		month	How many people were killed in 09/2016 (month) in ('Illinois', 'Champaign') (city) ?	5	0	0	0	5	1	0
3-100236	injuring		first	year	How many people were injured in 2016 (year) that involve the name Oscar (first) ?	8	2	2	0	6	2	3
3-105922	injuring		last	day	How many people were injured in 18/01/2016 (day) that involve the name Carroll (last) ?	2	2	2	0	0	0	0
3-98561	injuring	state		month	How many people were injured in 03/2014 (month) in ('California',) (state) ?	3	3	3	0	0	10	11
3-89619	killing	city	full_name		How many people were killed in ('Indiana', 'Greensburg') (city) that involve the name Jason Forshee (full_name) ?	1	0	0	0	1	0	0
3-77645	killing	city		month	How many people were killed in 06/2016 (month) in ('California', 'Riverside (county)') (city) ?	1	0	0	0	1	1	0
3-74138	killing	state		year	How many people were killed in 2016 (year) in ('Florida',) (state) ?	45	51	35	16	10	29	48
3-95056	injuring	city		year	How many people were injured in 2016 (year) in ('Indiana', 'Indianapolis') (city) ?	11	19	8	11	3	5	15
3-95055	injuring	city		year	How many people were injured in 2015 (year) in ('Florida', 'West Palm Beach') (city) ?	3	2	2	0	1	2	4
3-74136	killing	state		year	How many people were killed in 2015 (year) in ('Arkansas',) (state) ?	13	18	11	7	2	7	13
3-99416	injuring	city		day	How many people were injured in 09/06/2016 (day) in ('Massachusetts', 'Springfield') (city) ?	1	1	1	0	0	2	0
3-74135	killing	state		year	How many people were killed in 2015 (year) in ('Wisconsin',) (state) ?	6	5	3	2	3	5	7
3-74134	killing	state		year	How many people were killed in 2015 (year) in ('New Mexico',) (state) ?	6	4	4	0	2	4	5
3-75465	killing	city		day	How many people were killed in 07/03/2013 (day) in ('Mississippi', 'Jackson') (city) ?	1	0	0	0	1	2	0
3-99894	injuring	city		day	How many people were injured in 02/07/2015 (day) in ('Texas', 'Dallas') (city) ?	1	0	0	0	1	1	0
3-108194	injuring	state	first		How many people were injured in ('Kentucky',) (state) that involve the name Kwame (first) ?	3	0	0	0	3	0	0
3-108195	injuring	state	first		How many people were injured in ('Florida',) (state) that involve the name Rosalba (first) ?	1	1	1	0	0	1	0
3-74131	killing	state		year	How many people were killed in 2016 (year) in ('Minnesota',) (state) ?	5	7	5	2	0	2	4
3-96008	injuring	city		month	How many people were injured in 05/2014 (month) in ('Georgia', 'Atlanta') (city) ?	2	1	1	0	1	5	5
3-74217	killing	state		year	How many people were killed in 2015 (year) in ('New York',) (state) ?	24	0	0	0	24	14	0
3-86204	killing		first	year	How many people were killed in 2014 (year) that involve the name Eugene (first) ?	3	2	2	0	1	1	2
3-96492	injuring	city		month	How many people were injured in 07/2015 (month) in ('Texas', 'Dallas') (city) ?	3	1	1	0	2	6	0
3-106405	injuring		first	day	How many people were injured in 22/01/2016 (day) that involve the name Kahleal (first) ?	7	1	1	0	6	0	0
3-76404	killing	state		month	How many people were killed in 07/2015 (month) in ('Louisiana',) (state) ?	4	5	4	1	0	5	2
3-75557	killing	city		day	How many people were killed in 15/12/2013 (day) in ('Florida', 'Homestead (Florida City)') (city) ?	2	0	0	0	2	1	0
3-99523	injuring	city		day	How many people were injured in 02/04/2015 (day) in ('Florida', 'Debary') (city) ?	1	1	1	0	0	1	0
3-74224	killing	state		year	How many people were killed in 2016 (year) in ('Kansas',) (state) ?	6	5	1	4	5	3	3
3-98679	injuring	state		month	How many people were injured in 04/2016 (month) in ('Florida',) (state) ?	8	7	4	3	4	7	6
3-74223	killing	state		year	How many people were killed in 2016 (year) in ('Illinois',) (state) ?	59	30	23	7	36	40	31
3-96017	injuring	city		month	How many people were injured in 09/2016 (month) in ('South Carolina', 'Townville') (city) ?	3	0	0	0	3	2	0
3-98672	injuring	state		month	How many people were injured in 10/2016 (month) in ('Florida',) (state) ?	5	6	5	1	0	7	8
3-74220	killing	state		year	How many people were killed in 2014 (year) in ('Oklahoma',) (state) ?	5	5	5	0	0	5	3
3-76880	killing	state		day	How many people were killed in 03/08/2014 (day) in ('Virginia',) (state) ?	2	1	1	0	1	5	0
3-99521	injuring	city		day	How many people were injured in 26/07/2014 (day) in ('Arkansas', 'Pine Bluff') (city) ?	1	1	1	0	0	3	3
3-99506	injuring	city		day	How many people were injured in 20/12/2015 (day) in ('North Carolina', 'Wilmington') (city) ?	1	1	1	0	0	4	3
3-74229	killing	state		year	How many people were killed in 2014 (year) in ('Arkansas',) (state) ?	2	3	2	1	0	5	7
3-98658	injuring	state		month	How many people were injured in 08/2016 (month) in ('Nevada',) (state) ?	2	1	1	0	1	1	0
3-74228	killing	state		year	How many people were killed in 2015 (year) in ('Utah',) (state) ?	3	3	3	0	0	5	2
3-76405	killing	state		month	How many people were killed in 08/2016 (month) in ('Texas',) (state) ?	11	12	8	4	3	5	13
3-76889	killing	state		day	How many people were killed in 23/07/2016 (day) in ('Texas',) (state) ?	3	3	3	0	0	4	2
3-84032	killing		full_name	month	How many people were killed in 11/2016 (month) that involve the name Dylan Prosser (full_name) ?	1	0	0	0	1	0	0
3-86693	killing		first	year	How many people were killed in 2016 (year) that involve the name Ryan (first) ?	5	8	4	4	1	1	4
3-87540	killing		last	month	How many people were killed in 04/2015 (month) that involve the name Richardson (last) ?	1	1	1	0	0	1	1
3-102039	injuring		last	month	How many people were injured in 10/2016 (month) that involve the name Austin (last) ?	1	0	0	0	1	1	0
3-77740	killing	city		month	How many people were killed in 09/2016 (month) in ('Texas', 'Houston') (city) ?	11	7	7	0	4	3	4
3-76894	killing	state		day	How many people were killed in 06/05/2016 (day) in ('Arizona',) (state) ?	1	0	0	0	1	1	0
3-101188	injuring		first	month	How many people were injured in 09/2016 (month) that involve the name Heaven (first) ?	3	0	0	0	3	0	0
3-102035	injuring		last	month	How many people were injured in 10/2016 (month) that involve the name Spencer (last) ?	2	1	1	0	1	0	1
3-105546	injuring		full_name	day	How many people were injured in 24/12/2016 (day) that involve the name Daisy Joins (full_name) ?	3	2	2	0	1	1	7
3-77743	killing	city		month	How many people were killed in 11/2014 (month) in ('Florida', 'Miami') (city) ?	1	1	1	0	0	1	1
3-86209	killing		first	year	How many people were killed in 2016 (year) that involve the name Kenneth (first) ?	5	7	4	3	1	0	15
3-76898	killing	state		day	How many people were killed in 10/11/2016 (day) in ('Texas',) (state) ?	2	2	2	0	0	5	2
3-86206	killing		first	year	How many people were killed in 2016 (year) that involve the name Diana (first) ?	4	5	3	2	1	0	4
3-74237	killing	state		year	How many people were killed in 2016 (year) in ('Michigan',) (state) ?	51	18	10	8	41	23	22
3-75568	killing	city		day	How many people were killed in 13/08/2016 (day) in ('Wisconsin', 'Milwaukee') (city) ?	2	0	0	0	2	2	0
3-96487	injuring	city		month	How many people were injured in 04/2015 (month) in ('North Carolina', 'Charlotte') (city) ?	1	0	0	0	1	4	0
3-98666	injuring	state		month	How many people were injured in 05/2015 (month) in ('Louisiana',) (state) ?	3	3	3	0	0	3	3
3-99513	injuring	city		day	How many people were injured in 22/06/2013 (day) in ('Rhode Island', 'Providence') (city) ?	2	0	0	0	2	4	0
3-74236	killing	state		year	How many people were killed in 2014 (year) in ('California',) (state) ?	13	12	10	2	3	16	23
3-96488	injuring	city		month	How many people were injured in 02/2015 (month) in ('California', 'Long Beach') (city) ?	2	0	0	0	2	5	0
3-99996	injuring		first	year	How many people were injured in 2016 (year) that involve the name Emma (first) ?	5	2	2	0	3	1	4
3-96005	injuring	city		month	How many people were injured in 08/2016 (month) in ('Michigan', 'Pontiac') (city) ?	3	0	0	0	3	3	0
3-99514	injuring	city		day	How many people were injured in 26/09/2016 (day) in ('Georgia', 'Norcross') (city) ?	1	0	0	0	1	1	0
3-74233	killing	state		year	How many people were killed in 2015 (year) in ('California',) (state) ?	26	25	22	3	4	29	27
3-75564	killing	city		day	How many people were killed in 26/07/2014 (day) in ('Maine', 'Saco') (city) ?	1	0	0	0	1	5	0
3-99993	injuring		first	year	How many people were injured in 2016 (year) that involve the name Kevin (first) ?	7	19	5	14	2	1	44
3-74232	killing	state		year	How many people were killed in 2014 (year) in ('Tennessee',) (state) ?	5	5	3	2	2	5	6
3-74231	killing	state		year	How many people were killed in 2014 (year) in ('Virginia',) (state) ?	5	3	3	0	2	7	2
3-96469	injuring	city		month	How many people were injured in 02/2016 (month) in ('Florida', 'Daytona Beach') (city) ?	2	2	1	1	1	4	5
3-109933	injuring	city	last		How many people were injured in ('New Jersey', 'Jersey City') (city) that involve the name Green (last) ?	1	0	0	0	1	2	0
3-77705	killing	city		month	How many people were killed in 12/2016 (month) in ('Mississippi', 'Meridian') (city) ?	1	0	0	0	1	1	0
3-83151	killing		last	day	How many people were killed in 02/09/2014 (day) that involve the name McElroy (last) ?	1	1	1	0	0	2	3
3-84482	killing		full_name	month	How many people were killed in 10/2015 (month) that involve the name Adonis Brown (full_name) ?	5	0	0	0	5	0	0
3-96470	injuring	city		month	How many people were injured in 04/2015 (month) in ('Maryland', 'Baltimore') (city) ?	1	0	0	0	1	5	0
3-84479	killing		full_name	month	How many people were killed in 06/2016 (month) that involve the name Raekwon Brown (full_name) ?	6	3	3	0	3	1	0
3-103398	injuring		last	year	How many people were injured in 2013 (year) that involve the name Price (last) ?	4	1	1	0	3	1	0
3-86657	killing		first	year	How many people were killed in 2016 (year) that involve the name Destiny (first) ?	4	3	3	0	1	2	3
3-87989	killing	state	first		How many people were killed in ('Texas',) (state) that involve the name Christopher (first) ?	4	6	2	4	2	3	8
3-74204	killing	state		year	How many people were killed in 2014 (year) in ('Michigan',) (state) ?	13	1	1	0	12	10	0
3-74202	killing	state		year	How many people were killed in 2013 (year) in ('Texas',) (state) ?	7	8	7	1	0	4	10
3-99988	injuring		first	year	How many people were injured in 2016 (year) that involve the name Derrius (first) ?	8	3	3	0	5	0	4
3-74201	killing	state		year	How many people were killed in 2016 (year) in ('New Jersey',) (state) ?	22	17	16	1	6	12	8
3-102060	injuring		last	month	How many people were injured in 06/2014 (month) that involve the name Holliman (last) ?	1	1	1	0	0	0	2
3-75531	killing	city		day	How many people were killed in 04/12/2014 (day) in ('Texas', 'Arlington') (city) ?	1	0	0	0	1	1	0
3-86670	killing		first	year	How many people were killed in 2015 (year) that involve the name Ryan (first) ?	3	6	1	5	2	1	7
3-74207	killing	state		year	How many people were killed in 2014 (year) in ('New Jersey',) (state) ?	2	1	1	0	1	3	1
3-107742	injuring	state	first		How many people were injured in ('California',) (state) that involve the name Shunsie (first) ?	2	1	1	0	1	0	0
3-96460	injuring	city		month	How many people were injured in 02/2016 (month) in ('South Carolina', 'Spartanburg') (city) ?	1	1	1	0	0	1	0
3-105568	injuring		last	day	How many people were injured in 07/08/2016 (day) that involve the name Bell (last) ?	2	0	0	0	2	0	0
3-84007	killing		full_name	month	How many people were killed in 12/2016 (month) that involve the name Bryant Silk (full_name) ?	1	0	0	0	1	0	0
3-86668	killing		first	year	How many people were killed in 2015 (year) that involve the name Marquise (first) ?	2	3	1	2	1	0	1
3-74699	killing	city		year	How many people were killed in 2015 (year) in ('Texas', 'San Antonio') (city) ?	7	2	2	0	5	3	4
3-99975	injuring		first	year	How many people were injured in 2015 (year) that involve the name Robert (first) ?	3	11	2	9	1	0	7
3-74214	killing	state		year	How many people were killed in 2014 (year) in ('Indiana',) (state) ?	5	5	3	2	2	7	2
3-98643	injuring	state		month	How many people were injured in 07/2016 (month) in ('Texas',) (state) ?	25	30	19	11	6	19	33
3-74697	killing	city		year	How many people were killed in 2016 (year) in ('Arkansas', 'Little Rock') (city) ?	11	4	3	1	8	4	1
3-103384	injuring		last	year	How many people were injured in 2015 (year) that involve the name Craven (last) ?	1	2	1	1	0	1	1
3-74212	killing	state		year	How many people were killed in 2016 (year) in ('Georgia',) (state) ?	27	27	16	11	11	25	17
3-94283	injuring	state		day	How many people were injured in 09/03/2014 (day) in ('Texas',) (state) ?	1	1	1	0	0	6	6
3-74211	killing	state		year	How many people were killed in 2013 (year) in ('Maryland',) (state) ?	8	9	6	3	2	4	9
3-74695	killing	city		year	How many people were killed in 2016 (year) in ('Kansas', 'Wichita') (city) ?	4	0	0	0	4	2	0
3-103382	injuring		last	year	How many people were injured in 2016 (year) that involve the name Williams (last) ?	4	39	4	35	0	0	65
3-99959	injuring		first	year	How many people were injured in 2016 (year) that involve the name Taiquan (first) ?	2	1	1	0	1	1	5
3-88821	killing	city	last		How many people were killed in ('Alabama', 'Mobile') (city) that involve the name Russell (last) ?	1	0	0	0	1	0	0
3-105516	injuring		full_name	day	How many people were injured in 30/11/2013 (day) that involve the name Shekirrah Thomas (full_name) ?	1	1	1	0	0	1	0
3-88819	killing	city	last		How many people were killed in ('Kentucky', 'White Plains') (city) that involve the name Whitaker (last) ?	2	0	0	0	2	1	0
3-103337	injuring		last	year	How many people were injured in 2016 (year) that involve the name Jackson (last) ?	12	38	7	31	5	1	54
3-94271	injuring	state		day	How many people were injured in 25/11/2013 (day) in ('California',) (state) ?	3	2	2	0	1	7	7
3-86635	killing		first	year	How many people were killed in 2015 (year) that involve the name Anthony (first) ?	5	6	2	4	3	0	16
3-96454	injuring	city		month	How many people were injured in 04/2016 (month) in ('New Jersey', 'Orange') (city) ?	1	0	0	0	1	3	0
3-103331	injuring		last	year	How many people were injured in 2016 (year) that involve the name Watson (last) ?	7	4	4	0	3	1	11
3-98632	injuring	state		month	How many people were injured in 05/2016 (month) in ('Nevada',) (state) ?	2	1	1	0	1	4	4
3-94273	injuring	state		day	How many people were injured in 16/05/2013 (day) in ('Pennsylvania',) (state) ?	2	0	0	0	2	4	0
3-94279	injuring	state		day	How many people were injured in 30/06/2016 (day) in ('Illinois',) (state) ?	2	1	0	1	2	4	0
3-94278	injuring	state		day	How many people were injured in 08/10/2016 (day) in ('New York',) (state) ?	2	0	0	0	2	4	0
3-94277	injuring	state		day	How many people were injured in 19/06/2016 (day) in ('Arkansas',) (state) ?	1	1	1	0	0	1	1
3-96452	injuring	city		month	How many people were injured in 01/2014 (month) in ('North Carolina', 'Rocky Mount') (city) ?	1	0	0	0	1	4	0
3-96453	injuring	city		month	How many people were injured in 10/2015 (month) in ('Tennessee', 'Nashville') (city) ?	1	1	0	1	1	3	0
3-98618	injuring	state		month	How many people were injured in 10/2015 (month) in ('Tennessee',) (state) ?	4	4	3	1	1	11	9
3-94259	injuring	state		day	How many people were injured in 15/03/2015 (day) in ('California',) (state) ?	1	0	0	0	1	4	0
3-95106	injuring	city		year	How many people were injured in 2016 (year) in ('South Carolina', 'Myrtle Beach') (city) ?	2	2	2	0	0	5	5
3-95105	injuring	city		year	How many people were injured in 2014 (year) in ('South Carolina', 'Columbia') (city) ?	1	0	0	0	1	1	0
3-99946	injuring		first	year	How many people were injured in 2016 (year) that involve the name Stephen (first) ?	1	8	1	7	0	0	11
3-99948	injuring		first	year	How many people were injured in 2014 (year) that involve the name Eugene (first) ?	3	2	2	0	1	0	9
3-98616	injuring	state		month	How many people were injured in 08/2014 (month) in ('Pennsylvania',) (state) ?	3	2	2	0	1	8	4
3-76847	killing	state		day	How many people were killed in 05/08/2014 (day) in ('Connecticut',) (state) ?	2	1	1	0	1	1	0
3-86654	killing		first	year	How many people were killed in 2015 (year) that involve the name Christopher (first) ?	5	6	2	4	3	3	10
3-106829	injuring		first	day	How many people were injured in 07/07/2013 (day) that involve the name Jarvis (first) ?	2	1	1	0	1	0	5
3-83141	killing		last	day	How many people were killed in 23/07/2016 (day) that involve the name Rodriguez (last) ?	3	3	3	0	0	2	2
3-110094	injuring	city	last		How many people were injured in ('Tennessee', 'Memphis') (city) that involve the name Malone (last) ?	4	0	0	0	4	0	0
3-104658	injuring		full_name	year	How many people were injured in 2016 (year) that involve the name Chadney Allen (full_name) ?	6	2	2	0	4	0	2
3-105988	injuring		last	day	How many people were injured in 29/10/2014 (day) that involve the name English (last) ?	1	0	0	0	1	0	0
3-101143	injuring		first	month	How many people were injured in 11/2015 (month) that involve the name Amar (first) ?	2	2	2	0	0	0	0
3-85799	killing		first	year	How many people were killed in 2013 (year) that involve the name Angel (first) ?	4	3	2	1	2	0	2
3-100298	injuring		first	year	How many people were injured in 2015 (year) that involve the name Corey (first) ?	2	5	1	4	1	0	7
3-83139	killing		last	day	How many people were killed in 13/09/2014 (day) that involve the name Mayes (last) ?	2	0	0	0	2	1	0
3-104653	injuring		full_name	year	How many people were injured in 2016 (year) that involve the name Terrance Givens (full_name) ?	1	1	1	0	0	0	2
3-95111	injuring	city		year	How many people were injured in 2016 (year) in ('Illinois', 'Chicago (Chicago Lawn)') (city) ?	1	24	1	23	0	1	23
3-99952	injuring		first	year	How many people were injured in 2014 (year) that involve the name Kenneth (first) ?	6	3	3	0	3	1	9
3-100294	injuring		first	year	How many people were injured in 2016 (year) that involve the name Tyler (first) ?	4	3	2	1	2	1	12
3-101142	injuring		first	month	How many people were injured in 01/2015 (month) that involve the name Ladarius (first) ?	2	0	0	0	2	0	0
3-96445	injuring	city		month	How many people were injured in 04/2016 (month) in ('Maryland', 'Temple Hills') (city) ?	4	0	0	0	4	2	0
3-74674	killing	city		year	How many people were killed in 2015 (year) in ('Indiana', 'Indianapolis') (city) ?	8	2	2	0	6	8	3
3-95115	injuring	city		year	How many people were injured in 2015 (year) in ('Mississippi', 'Forest') (city) ?	2	0	0	0	2	3	0
3-96440	injuring	city		month	How many people were injured in 05/2015 (month) in ('Missouri', 'Kinloch') (city) ?	1	1	1	0	0	4	0
3-96442	injuring	city		month	How many people were injured in 06/2016 (month) in ('North Carolina', 'Henderson') (city) ?	1	0	0	0	1	2	0
3-99938	injuring	city		day	How many people were injured in 12/08/2016 (day) in ('Texas', 'Dallas') (city) ?	4	3	3	0	1	3	5
3-94247	injuring	state		day	How many people were injured in 21/08/2016 (day) in ('Massachusetts',) (state) ?	2	0	0	0	2	4	0
3-98604	injuring	state		month	How many people were injured in 12/2016 (month) in ('Arizona',) (state) ?	4	2	2	0	2	3	0
3-75967	killing	state		month	How many people were killed in 12/2015 (month) in ('North Carolina',) (state) ?	2	2	2	0	0	2	3
3-96426	injuring	city		month	How many people were injured in 08/2016 (month) in ('Texas', 'Dallas') (city) ?	6	4	4	0	2	4	5
3-76812	killing	state		day	How many people were killed in 14/12/2015 (day) in ('Arizona',) (state) ?	1	1	1	0	0	3	0
3-85776	killing		first	year	How many people were killed in 2016 (year) that involve the name Christopher (first) ?	20	25	16	9	4	9	17
3-87952	killing	state	first		How many people were killed in ('Illinois',) (state) that involve the name Kortney (first) ?	2	2	2	0	0	2	2
3-105529	injuring		full_name	day	How many people were injured in 02/08/2016 (day) that involve the name Mason Powell (full_name) ?	1	0	0	0	1	0	0
3-86619	killing		first	year	How many people were killed in 2016 (year) that involve the name John (first) ?	9	28	8	20	1	2	12
3-107708	injuring	state	first		How many people were injured in ('New York',) (state) that involve the name Errol (first) ?	4	0	0	0	4	0	0
3-103358	injuring		last	year	How many people were injured in 2016 (year) that involve the name Hall (last) ?	4	7	3	4	1	0	19
3-82257	killing		last	year	How many people were killed in 2016 (year) that involve the name Miller (last) ?	6	17	3	14	3	1	21
3-101176	injuring		first	month	How many people were injured in 01/2013 (month) that involve the name Julian (first) ?	2	2	2	0	0	0	8
3-86614	killing		first	year	How many people were killed in 2016 (year) that involve the name Jesus (first) ?	3	2	2	0	1	2	2
3-87945	killing	state	first		How many people were killed in ('Kentucky',) (state) that involve the name Kieara (first) ?	1	0	0	0	1	1	0
3-75974	killing	state		month	How many people were killed in 06/2016 (month) in ('Texas',) (state) ?	10	12	9	3	1	6	12
3-96434	injuring	city		month	How many people were injured in 05/2015 (month) in ('Maryland', 'Baltimore') (city) ?	1	1	1	0	0	5	2
3-104680	injuring		full_name	year	How many people were injured in 2016 (year) that involve the name Alana Tello (full_name) ?	2	1	1	0	1	0	5
3-95102	injuring	city		year	How many people were injured in 2016 (year) in ('Alabama', 'Montgomery') (city) ?	3	1	0	1	3	6	1
3-96430	injuring	city		month	How many people were injured in 10/2016 (month) in ('Nevada', 'Reno') (city) ?	2	1	1	0	1	2	0
3-93389	injuring	state		day	How many people were injured in 14/11/2016 (day) in ('Texas',) (state) ?	3	1	1	0	2	2	2
3-99929	injuring	city		day	How many people were injured in 06/11/2015 (day) in ('California', 'Bakersfield') (city) ?	1	0	0	0	1	4	0
3-75977	killing	state		month	How many people were killed in 06/2016 (month) in ('Colorado',) (state) ?	5	3	3	0	2	3	6
3-105527	injuring		full_name	day	How many people were injured in 25/08/2013 (day) that involve the name Damien Simpson (full_name) ?	2	0	0	0	2	0	0
3-83116	killing		last	day	How many people were killed in 20/12/2016 (day) that involve the name Kassner (last) ?	1	1	1	0	0	0	0
3-75986	killing	state		month	How many people were killed in 11/2015 (month) in ('Texas',) (state) ?	4	4	3	1	1	3	4
3-103342	injuring		last	year	How many people were injured in 2013 (year) that involve the name Williams (last) ?	8	6	5	1	3	2	20
3-99930	injuring	city		day	How many people were injured in 09/08/2016 (day) in ('Pennsylvania', 'Harrisburg') (city) ?	1	0	0	0	1	1	0
3-93393	injuring	state		day	How many people were injured in 23/02/2016 (day) in ('Florida',) (state) ?	4	4	4	0	0	5	6
3-96423	injuring	city		month	How many people were injured in 11/2014 (month) in ('Florida', 'Miami') (city) ?	1	1	1	0	0	3	3
3-101163	injuring		first	month	How many people were injured in 07/2014 (month) that involve the name Dayron (first) ?	1	0	0	0	1	0	0
3-93396	injuring	state		day	How many people were injured in 26/09/2016 (day) in ('Texas',) (state) ?	11	8	7	1	4	10	19
3-96407	injuring	city		month	How many people were injured in 09/2016 (month) in ('North Carolina', 'New Bern') (city) ?	1	0	0	0	1	5	0
3-99917	injuring	city		day	How many people were injured in 30/07/2016 (day) in ('Missouri', 'Saint Louis') (city) ?	2	0	0	0	2	5	0
3-75949	killing	state		month	How many people were killed in 11/2014 (month) in ('Colorado',) (state) ?	4	3	3	0	1	2	2
3-94227	injuring	state		day	How many people were injured in 10/12/2016 (day) in ('Florida',) (state) ?	1	1	0	1	1	1	2
3-93379	injuring	state		day	How many people were injured in 16/09/2016 (day) in ('California',) (state) ?	1	1	1	0	0	2	0
3-99919	injuring	city		day	How many people were injured in 01/08/2016 (day) in ('South Carolina', 'Greenville') (city) ?	1	0	0	0	1	1	0
3-99912	injuring	city		day	How many people were injured in 18/08/2016 (day) in ('Illinois', 'Peoria') (city) ?	1	0	0	0	1	2	0
3-75943	killing	state		month	How many people were killed in 10/2016 (month) in ('Illinois',) (state) ?	10	5	4	1	6	8	6
3-82244	killing		last	year	How many people were killed in 2016 (year) that involve the name Martinez (last) ?	6	12	6	6	0	2	8
3-85750	killing		first	year	How many people were killed in 2015 (year) that involve the name Kevin (first) ?	8	12	2	10	6	1	7
3-85745	killing		first	year	How many people were killed in 2016 (year) that involve the name Robert (first) ?	4	18	2	16	2	2	7
3-106006	injuring		last	day	How many people were injured in 10/11/2016 (day) that involve the name Barriere (last) ?	1	1	1	0	0	0	1
3-107332	injuring	city	first		How many people were injured in ('Missouri', 'Saint Louis') (city) that involve the name Damani (first) ?	1	1	1	0	0	0	2
3-105153	injuring		full_name	day	How many people were injured in 14/09/2016 (day) that involve the name Mariah Loredo (full_name) ?	3	1	1	0	2	0	0
3-93388	injuring	state		day	How many people were injured in 21/11/2015 (day) in ('Wisconsin',) (state) ?	1	0	0	0	1	1	0
3-94217	injuring	state		day	How many people were injured in 02/10/2015 (day) in ('Maryland',) (state) ?	1	2	1	1	0	4	8
3-109980	injuring	city	last		How many people were injured in ('Washington', 'Seattle') (city) that involve the name Rasul-Chiono (last) ?	4	0	0	0	4	0	0
3-94214	injuring	state		day	How many people were injured in 11/11/2016 (day) in ('Wisconsin',) (state) ?	1	0	0	0	1	1	0
3-94698	injuring	city		year	How many people were injured in 2016 (year) in ('Kentucky', 'Louisville') (city) ?	3	0	0	0	3	2	0
3-109984	injuring	city	last		How many people were injured in ('Pennsylvania', 'Philadelphia') (city) that involve the name Jones (last) ?	2	1	1	0	1	2	0
3-110973	injuring	state	full_name		How many people were injured in ('Arkansas',) (state) that involve the name Linquinton Dean (full_name) ?	4	0	0	0	4	0	0
3-108655	injuring	state	last		How many people were injured in ('California',) (state) that involve the name Johnson (last) ?	6	7	2	5	4	0	8
3-109986	injuring	city	last		How many people were injured in ('Michigan', 'Detroit') (city) that involve the name Williams (last) ?	4	5	2	3	2	1	19
3-75954	killing	state		month	How many people were killed in 02/2015 (month) in ('Texas',) (state) ?	6	6	4	2	2	9	3
3-99903	injuring	city		day	How many people were injured in 28/11/2016 (day) in ('California', 'Wilmington') (city) ?	2	1	1	0	1	4	1
3-82253	killing		last	year	How many people were killed in 2016 (year) that involve the name Knarr (last) ?	1	0	0	0	1	3	0
3-76807	killing	state		day	How many people were killed in 28/09/2015 (day) in ('Illinois',) (state) ?	3	0	0	0	3	3	0
3-85760	killing		first	year	How many people were killed in 2016 (year) that involve the name Nathaniel (first) ?	4	4	2	2	2	1	1
3-86606	killing		first	year	How many people were killed in 2016 (year) that involve the name Marcus (first) ?	6	5	3	2	3	1	4
3-76810	killing	state		day	How many people were killed in 22/11/2016 (day) in ('Arkansas',) (state) ?	4	3	2	1	2	2	1
3-93372	injuring	state		day	How many people were injured in 18/10/2014 (day) in ('New York',) (state) ?	2	0	0	0	2	8	0
3-105144	injuring		full_name	day	How many people were injured in 25/11/2016 (day) that involve the name Robert Long (full_name) ?	2	0	0	0	2	0	0
3-104297	injuring		full_name	year	How many people were injured in 2015 (year) that involve the name John Hershberger (full_name) ?	1	1	1	0	0	1	1
3-93359	injuring	state		day	How many people were injured in 21/02/2016 (day) in ('Texas',) (state) ?	4	3	3	0	1	5	5
3-108203	injuring	state	first		How many people were injured in ('Alabama',) (state) that involve the name Deosha (first) ?	1	1	1	0	0	0	4
3-82220	killing		last	year	How many people were killed in 2016 (year) that involve the name Thomas (last) ?	4	16	4	12	0	2	7
3-100718	injuring		first	year	How many people were injured in 2016 (year) that involve the name Anthony (first) ?	10	20	5	15	5	3	22
3-81371	killing		full_name	year	How many people were killed in 2014 (year) that involve the name Neely Gardner (full_name) ?	4	0	0	0	4	0	0
3-85723	killing		first	year	How many people were killed in 2015 (year) that involve the name Thomas (first) ?	9	7	6	1	3	4	11
3-82214	killing		last	year	How many people were killed in 2016 (year) that involve the name Turner (last) ?	3	7	1	6	2	2	1
3-82698	killing		last	year	How many people were killed in 2015 (year) that involve the name Green (last) ?	4	4	2	2	2	1	1
3-83547	killing		last	day	How many people were killed in 14/10/2016 (day) that involve the name Brinson (last) ?	2	1	1	0	1	1	1
3-84878	killing		full_name	day	How many people were killed in 18/03/2016 (day) that involve the name Queshandis Seals (full_name) ?	3	0	0	0	3	0	0
3-85725	killing		first	year	How many people were killed in 2016 (year) that involve the name Jacob (first) ?	11	9	9	0	2	4	2
3-94213	injuring	state		day	How many people were injured in 13/11/2016 (day) in ('Texas',) (state) ?	2	2	2	0	0	4	8
3-107352	injuring	city	first		How many people were injured in ('Rhode Island', 'Providence') (city) that involve the name Oeun (first) ?	2	0	0	0	2	1	0
3-93364	injuring	state		day	How many people were injured in 19/03/2016 (day) in ('Texas',) (state) ?	2	2	2	0	0	2	0
3-94695	injuring	city		year	How many people were injured in 2016 (year) in ('Virginia', 'Norfolk') (city) ?	3	5	3	2	0	9	4
3-94679	injuring	city		year	How many people were injured in 2013 (year) in ('District of Columbia', 'Washington') (city) ?	5	0	0	0	5	9	0
3-93347	injuring	state		day	How many people were injured in 31/08/2016 (day) in ('Massachusetts',) (state) ?	1	1	1	0	0	1	1
3-94678	injuring	city		year	How many people were injured in 2013 (year) in ('Florida', 'Belle Glade') (city) ?	2	0	0	0	2	5	0
3-93346	injuring	state		day	How many people were injured in 28/10/2016 (day) in ('Mississippi',) (state) ?	2	2	2	0	0	6	9
3-94677	injuring	city		year	How many people were injured in 2015 (year) in ('Tennessee', 'Nashville') (city) ?	4	7	3	4	1	6	2
3-83564	killing		last	day	How many people were killed in 09/04/2016 (day) that involve the name Galarza (last) ?	2	2	2	0	0	0	0
3-84890	killing		full_name	day	How many people were killed in 25/12/2015 (day) that involve the name Maleah Williams (full_name) ?	1	1	1	0	0	1	1
3-82224	killing		last	year	How many people were killed in 2016 (year) that involve the name Graham (last) ?	2	1	1	0	1	0	0
3-85734	killing		first	year	How many people were killed in 2014 (year) that involve the name Jakairion (first) ?	1	0	0	0	1	0	0
3-87914	killing	state	first		How many people were killed in ('California',) (state) that involve the name Luis (first) ?	3	6	2	4	1	2	0
3-106015	injuring		last	day	How many people were injured in 29/10/2016 (day) that involve the name Appels (last) ?	2	0	0	0	2	0	0
3-93350	injuring	state		day	How many people were injured in 13/08/2016 (day) in ('Missouri',) (state) ?	3	0	0	0	3	1	0
3-105164	injuring		full_name	day	How many people were injured in 10/07/2016 (day) that involve the name Rachel Hinson (full_name) ?	2	2	2	0	0	0	8
3-94685	injuring	city		year	How many people were injured in 2015 (year) in ('Texas', 'Houston') (city) ?	6	12	5	7	1	14	27
3-93353	injuring	state		day	How many people were injured in 04/11/2016 (day) in ('Pennsylvania',) (state) ?	3	3	3	0	0	6	5
3-94684	injuring	city		year	How many people were injured in 2015 (year) in ('Virginia', 'Newport News') (city) ?	1	0	0	0	1	1	0
3-94665	injuring	city		year	How many people were injured in 2015 (year) in ('Tennessee', 'Chattanooga') (city) ?	1	2	1	1	0	1	0
3-95997	injuring	city		month	How many people were injured in 08/2015 (month) in ('Missouri', 'Saint Louis') (city) ?	2	2	1	1	1	4	5
3-95999	injuring	city		month	How many people were injured in 11/2016 (month) in ('Texas', 'Fort Worth') (city) ?	2	1	1	0	1	1	0
3-82683	killing		last	year	How many people were killed in 2015 (year) that involve the name Clayton (last) ?	7	4	4	0	3	1	5
3-84859	killing		full_name	day	How many people were killed in 22/12/2015 (day) that involve the name Nikolai Wasilewski (full_name) ?	1	0	0	0	1	0	0
3-85706	killing		first	year	How many people were killed in 2015 (year) that involve the name Trevor (first) ?	3	1	1	0	2	1	1
3-81346	killing		full_name	year	How many people were killed in 2016 (year) that involve the name Emarjae Watkins (full_name) ?	4	1	1	0	3	1	0
3-105112	injuring		full_name	day	How many people were injured in 24/05/2015 (day) that involve the name Rodriquez Smith (full_name) ?	1	0	0	0	1	0	0
3-94675	injuring	city		year	How many people were injured in 2015 (year) in ('Florida', 'Orlando') (city) ?	2	0	0	0	2	6	0
3-105592	injuring		last	day	How many people were injured in 11/08/2016 (day) that involve the name Hopper (last) ?	3	1	1	0	2	0	1
3-94655	injuring	city		year	How many people were injured in 2016 (year) in ('Connecticut', 'Bridgeport') (city) ?	10	3	3	0	7	22	1
3-95985	injuring	city		month	How many people were injured in 07/2014 (month) in ('Michigan', 'Kalamazoo') (city) ?	1	1	1	0	0	4	4
3-93329	injuring	state		day	How many people were injured in 11/10/2016 (day) in ('Illinois',) (state) ?	1	0	0	0	1	1	0
3-95987	injuring	city		month	How many people were injured in 01/2013 (month) in ('California', 'Brentwood') (city) ?	1	0	0	0	1	4	0
3-94658	injuring	city		year	How many people were injured in 2015 (year) in ('Alabama', 'Jasper') (city) ?	1	0	0	0	1	2	0
3-108612	injuring	state	last		How many people were injured in ('New York',) (state) that involve the name Smith (last) ?	4	1	0	1	4	2	3
3-82693	killing		last	year	How many people were killed in 2016 (year) that involve the name Reed (last) ?	4	5	2	3	2	1	6
3-75918	killing	state		month	How many people were killed in 08/2016 (month) in ('Wisconsin',) (state) ?	3	4	3	1	0	3	0
3-80027	killing		first	day	How many people were killed in 14/07/2016 (day) that involve the name Gavin (first) ?	3	0	0	0	3	1	0
3-82208	killing		last	year	How many people were killed in 2016 (year) that involve the name Thompson (last) ?	5	11	3	8	2	2	11
3-102078	injuring		last	month	How many people were injured in 09/2015 (month) that involve the name Smith (last) ?	4	3	1	2	3	1	4
3-83533	killing		last	day	How many people were killed in 19/11/2016 (day) that involve the name Thompson (last) ?	2	2	2	0	0	2	3
3-95992	injuring	city		month	How many people were injured in 05/2015 (month) in ('Ohio', 'Cincinnati') (city) ?	1	0	0	0	1	4	0
3-104252	injuring		full_name	year	How many people were injured in 2016 (year) that involve the name Demontray Mackey (full_name) ?	2	1	1	0	1	0	5
3-106431	injuring		first	day	How many people were injured in 21/04/2016 (day) that involve the name Stephon (first) ?	1	1	1	0	0	0	4
3-79042	killing		first	month	How many people were killed in 12/2013 (month) that involve the name Derek (first) ?	1	0	0	0	1	1	0
3-92486	killing	state	last		How many people were killed in ('New Mexico',) (state) that involve the name Griego (last) ?	6	5	5	0	1	5	9
3-94663	injuring	city		year	How many people were injured in 2015 (year) in ('Ohio', 'Cincinnati') (city) ?	4	4	1	3	3	10	0
3-93331	injuring	state		day	How many people were injured in 04/07/2014 (day) in ('Virginia',) (state) ?	1	1	0	1	1	5	0
3-94662	injuring	city		year	How many people were injured in 2015 (year) in ('California', 'Sacramento') (city) ?	4	1	1	0	3	6	3
3-102072	injuring		last	month	How many people were injured in 07/2014 (month) that involve the name Bryant (last) ?	1	1	1	0	0	0	3
3-107792	injuring	state	first		How many people were injured in ('California',) (state) that involve the name Sungaya (first) ?	4	2	2	0	2	0	2
3-93796	injuring	state		day	How many people were injured in 10/04/2016 (day) in ('California',) (state) ?	2	1	1	0	1	6	2
3-94643	injuring	city		year	How many people were injured in 2015 (year) in ('Ohio', 'Toledo') (city) ?	7	2	2	0	5	4	1
3-93319	injuring	state		day	How many people were injured in 29/08/2016 (day) in ('Pennsylvania',) (state) ?	3	3	3	0	0	2	0
3-94649	injuring	city		year	How many people were injured in 2016 (year) in ('Georgia', 'Savannah') (city) ?	3	1	1	0	2	3	1
3-93317	injuring	state		day	How many people were injured in 06/02/2015 (day) in ('Oklahoma',) (state) ?	1	0	0	0	1	4	0
3-94648	injuring	city		year	How many people were injured in 2013 (year) in ('California', 'Palo Alto') (city) ?	4	4	4	0	0	5	11
3-95976	injuring	city		month	How many people were injured in 07/2015 (month) in ('Illinois', 'Rockford') (city) ?	1	0	0	0	1	5	0
3-82659	killing		last	year	How many people were killed in 2014 (year) that involve the name Booker (last) ?	4	3	3	0	1	2	5
3-105139	injuring		full_name	day	How many people were injured in 11/09/2016 (day) that involve the name Jhakwan Williams (full_name) ?	1	1	1	0	0	0	0
3-82656	killing		last	year	How many people were killed in 2015 (year) that involve the name Johnson (last) ?	7	9	5	4	2	4	14
3-79012	killing		first	month	How many people were killed in 08/2016 (month) that involve the name Thomas (first) ?	8	5	4	1	4	1	0
3-94653	injuring	city		year	How many people were injured in 2016 (year) in ('California', 'San Francisco') (city) ?	7	9	6	3	1	8	20
3-93321	injuring	state		day	How many people were injured in 03/05/2015 (day) in ('New York',) (state) ?	1	0	0	0	1	4	0
3-94634	injuring	city		year	How many people were injured in 2015 (year) in ('Ohio', 'Clark (county)') (city) ?	1	0	0	0	1	1	0
3-93302	killing	state	last		How many people were killed in ('Missouri',) (state) that involve the name Collins (last) ?	2	1	0	1	2	0	0
3-93308	injuring	state		day	How many people were injured in 19/07/2015 (day) in ('Kentucky',) (state) ?	4	4	4	0	0	6	13
3-94639	injuring	city		year	How many people were injured in 2015 (year) in ('Alabama', 'Tuscaloosa') (city) ?	1	0	0	0	1	1	0
3-93307	injuring	state		day	How many people were injured in 15/11/2013 (day) in ('Texas',) (state) ?	2	0	0	0	2	3	0
3-94638	injuring	city		year	How many people were injured in 2014 (year) in ('South Carolina', 'Moncks Corner') (city) ?	2	2	2	0	0	5	7
3-95964	injuring	city		month	How many people were injured in 08/2015 (month) in ('Florida', 'Miami') (city) ?	1	1	1	0	0	1	0
3-99091	injuring	city		day	How many people were injured in 17/06/2015 (day) in ('Pennsylvania', 'Pittsburgh') (city) ?	1	1	1	0	0	1	0
3-108638	injuring	state	last		How many people were injured in ('Florida',) (state) that involve the name Hernandez (last) ?	1	2	1	1	0	2	4
3-82669	killing		last	year	How many people were killed in 2015 (year) that involve the name Stasko (last) ?	1	1	1	0	0	3	3
3-107308	injuring	city	first		How many people were injured in ('Ohio', 'Bellefontaine') (city) that involve the name Javon (first) ?	2	0	0	0	2	1	0
3-83517	killing		last	day	How many people were killed in 25/09/2016 (day) that involve the name Martinez (last) ?	2	1	1	0	1	1	0
3-99095	injuring	city		day	How many people were injured in 14/11/2015 (day) in ('Oregon', 'Lebanon') (city) ?	1	0	0	0	1	1	0
3-90280	killing	state	full_name		How many people were killed in ('Virginia',) (state) that involve the name Shauna Washington (full_name) ?	2	0	0	0	2	1	0
3-104277	injuring		full_name	year	How many people were injured in 2015 (year) that involve the name Royal Willrich (full_name) ?	6	3	3	0	3	0	9
3-104275	injuring		full_name	year	How many people were injured in 2015 (year) that involve the name Destin Burks (full_name) ?	1	0	0	0	1	0	0
3-110947	injuring	state	full_name		How many people were injured in ('Georgia',) (state) that involve the name Tyricco Simmons (full_name) ?	1	1	1	0	0	0	0
3-92463	killing	state	last		How many people were killed in ('California',) (state) that involve the name Johnson (last) ?	6	6	2	4	4	1	12
3-94640	injuring	city		year	How many people were injured in 2016 (year) in ('Washington', 'Tacoma') (city) ?	3	0	0	0	3	5	0
3-93413	injuring	state		day	How many people were injured in 30/11/2014 (day) in ('New York',) (state) ?	3	0	0	0	3	4	0
3-107170	injuring	city	first		How many people were injured in ('Pennsylvania', 'Pittsburgh') (city) that involve the name Niles (first) ?	1	1	1	0	0	0	2
3-94746	injuring	city		year	How many people were injured in 2016 (year) in ('Pennsylvania', 'Harrisburg (Steelton)') (city) ?	2	0	0	0	2	1	0
3-82762	killing		last	year	How many people were killed in 2016 (year) that involve the name Murphy (last) ?	5	4	3	1	2	0	1
3-80583	killing		first	day	How many people were killed in 17/12/2016 (day) that involve the name Gary (first) ?	2	0	0	0	2	0	0
3-83605	killing		last	day	How many people were killed in 04/12/2016 (day) that involve the name Gonzalez (last) ?	2	1	1	0	1	0	1
3-81422	killing		full_name	year	How many people were killed in 2015 (year) that involve the name Aftab Alam (full_name) ?	1	1	1	0	0	1	0
3-82754	killing		last	year	How many people were killed in 2014 (year) that involve the name Miller (last) ?	3	6	2	4	1	2	2
3-76081	killing	state		month	How many people were killed in 11/2016 (month) in ('Alaska',) (state) ?	3	3	3	0	0	4	9
3-94750	injuring	city		year	How many people were injured in 2016 (year) in ('North Carolina', 'Charlotte') (city) ?	4	0	0	0	4	5	0
3-79596	killing		first	month	How many people were killed in 05/2015 (month) that involve the name Dante (first) ?	1	1	1	0	0	1	0
3-111662	job_firing	state	first		How many people were fired in ('Pennsylvania',) (state) that involve the name Natalie (first) ?	1	0	0	0	1	1	0
3-92556	killing	state	last		How many people were killed in ('Ohio',) (state) that involve the name Welch (last) ?	2	0	0	0	2	1	0
3-108013	injuring	state	first		How many people were injured in ('Pennsylvania',) (state) that involve the name Stephen (first) ?	6	2	1	1	5	0	4
3-94731	injuring	city		year	How many people were injured in 2014 (year) in ('California', 'Antioch') (city) ?	1	0	0	0	1	7	0
3-93407	injuring	state		day	How many people were injured in 08/06/2016 (day) in ('Massachusetts',) (state) ?	6	5	5	0	1	3	9
3-94737	injuring	city		year	How many people were injured in 2015 (year) in ('Texas', 'Killeen') (city) ?	4	0	0	0	4	2	0
3-94736	injuring	city		year	How many people were injured in 2016 (year) in ('Connecticut', 'Hartford') (city) ?	4	1	1	0	3	6	0
3-93888	injuring	state		day	How many people were injured in 05/06/2016 (day) in ('New York',) (state) ?	3	0	0	0	3	4	0
3-81440	killing		full_name	year	How many people were killed in 2015 (year) that involve the name Malik Jones (full_name) ?	2	1	1	0	1	1	1
3-81442	killing		full_name	year	How many people were killed in 2016 (year) that involve the name Thomas Lane (full_name) ?	3	1	1	0	2	1	0
3-100524	injuring		first	year	How many people were injured in 2013 (year) that involve the name Angel (first) ?	4	3	2	1	2	1	6
3-99197	injuring	city		day	How many people were injured in 01/10/2016 (day) in ('California', 'Fresno') (city) ?	1	1	1	0	0	4	4
3-100532	injuring		first	year	How many people were injured in 2014 (year) that involve the name Dearn (first) ?	1	1	1	0	0	0	2
3-99196	injuring	city		day	How many people were injured in 20/02/2016 (day) in ('Alabama', 'Bessemer') (city) ?	1	1	1	0	0	3	3
3-100533	injuring		first	year	How many people were injured in 2015 (year) that involve the name Alexis (first) ?	1	3	1	2	0	0	1
3-82769	killing		last	year	How many people were killed in 2016 (year) that involve the name Russell (last) ?	4	7	3	4	1	0	9
3-102711	injuring		full_name	month	How many people were injured in 04/2016 (month) that involve the name Triston Whitmire (full_name) ?	1	1	1	0	0	0	4
3-99198	injuring	city		day	How many people were injured in 28/11/2015 (day) in ('California', 'Fresno') (city) ?	1	0	0	0	1	1	0
3-81433	killing		full_name	year	How many people were killed in 2016 (year) that involve the name Kristopher Paro (full_name) ?	1	1	1	0	0	0	0
3-99195	injuring	city		day	How many people were injured in 27/07/2015 (day) in ('Missouri', 'Saint Louis') (city) ?	1	0	0	0	1	2	0
3-76094	killing	state		month	How many people were killed in 11/2015 (month) in ('California',) (state) ?	3	3	2	1	1	3	4
3-107166	injuring	city	first		How many people were injured in ('Illinois', 'Chicago') (city) that involve the name Markeyo (first) ?	1	0	0	0	1	0	0
3-76096	killing	state		month	How many people were killed in 05/2016 (month) in ('Iowa',) (state) ?	1	0	0	0	1	1	0
3-93892	injuring	state		day	How many people were injured in 09/11/2016 (day) in ('Illinois',) (state) ?	2	1	0	1	2	3	3
3-94722	injuring	city		year	How many people were injured in 2015 (year) in ('Indiana', 'Gary') (city) ?	4	0	0	0	4	5	0
3-93873	injuring	state		day	How many people were injured in 03/09/2016 (day) in ('Connecticut',) (state) ?	2	0	0	0	2	3	0
3-94728	injuring	city		year	How many people were injured in 2015 (year) in ('Kentucky', 'Lexington') (city) ?	4	0	0	0	4	5	0
3-101888	injuring		last	month	How many people were injured in 03/2016 (month) that involve the name Jones (last) ?	2	3	2	1	0	2	6
3-101406	injuring		first	month	How many people were injured in 12/2015 (month) that involve the name Raheem (first) ?	1	1	1	0	0	0	4
3-81405	killing		full_name	year	How many people were killed in 2016 (year) that involve the name Adrian Potts (full_name) ?	2	1	1	0	1	1	1
3-81884	killing		last	year	How many people were killed in 2014 (year) that involve the name Thomas (last) ?	7	2	1	1	6	1	2
3-77393	killing	city		month	How many people were killed in 11/2015 (month) in ('Louisiana', 'Saint Gabriel (Iberville)') (city) ?	1	0	0	0	1	1	0
3-82739	killing		last	year	How many people were killed in 2013 (year) that involve the name Smith (last) ?	3	3	3	0	0	1	2
3-79574	killing		first	month	How many people were killed in 12/2016 (month) that involve the name Aavaire (first) ?	4	1	1	0	3	0	0
3-111200	injuring	state	full_name		How many people were injured in ('Arkansas',) (state) that involve the name Dontaris Thomas (full_name) ?	1	0	0	0	1	0	0
3-89386	killing	city	last		How many people were killed in ('Virginia', 'Hampton') (city) that involve the name Rooks (last) ?	1	0	0	0	1	1	0
3-93864	injuring	state		day	How many people were injured in 28/09/2015 (day) in ('Ohio',) (state) ?	4	3	3	0	1	9	8
3-92538	killing	state	last		How many people were killed in ('Alabama',) (state) that involve the name Edwards (last) ?	2	1	1	0	1	1	2
3-94715	injuring	city		year	How many people were injured in 2013 (year) in ('California', 'Vallejo') (city) ?	7	2	2	0	5	16	3
3-100548	injuring		first	year	How many people were injured in 2016 (year) that involve the name Michael (first) ?	4	45	2	43	2	0	75
3-80566	killing		first	day	How many people were killed in 27/08/2015 (day) that involve the name Felicidad (first) ?	1	1	1	0	0	1	2
3-104912	injuring		full_name	year	How many people were injured in 2016 (year) that involve the name Francois Cunningham (full_name) ?	3	1	1	0	2	0	0
3-79106	killing		first	month	How many people were killed in 06/2016 (month) that involve the name Codie (first) ?	1	1	1	0	0	1	2
3-79108	killing		first	month	How many people were killed in 11/2016 (month) that involve the name Alana (first) ?	2	1	1	0	1	1	1
3-81894	killing		last	year	How many people were killed in 2016 (year) that involve the name Bellamy (last) ?	3	3	3	0	0	1	0
3-76070	killing	state		month	How many people were killed in 11/2016 (month) in ('California',) (state) ?	14	10	9	1	5	9	4
3-107188	injuring	city	first		How many people were injured in ('Illinois', 'Chicago') (city) that involve the name James (first) ?	1	1	0	1	1	0	0
3-82749	killing		last	year	How many people were killed in 2015 (year) that involve the name Anderson (last) ?	3	9	3	6	0	1	6
3-92541	killing	state	last		How many people were killed in ('Missouri',) (state) that involve the name Carr (last) ?	2	1	1	0	1	0	0
3-107186	injuring	city	first		How many people were injured in ('New York', 'Lake Placid') (city) that involve the name Jonathan (first) ?	3	0	0	0	3	0	0
3-94701	injuring	city		year	How many people were injured in 2013 (year) in ('Texas', 'Houston') (city) ?	5	10	5	5	0	6	22
3-94700	injuring	city		year	How many people were injured in 2015 (year) in ('California', 'Garden Grove') (city) ?	1	2	1	1	0	1	3
3-87174	killing		last	month	How many people were killed in 12/2015 (month) that involve the name Johnson (last) ?	4	3	3	0	1	3	9
3-94705	injuring	city		year	How many people were injured in 2016 (year) in ('New Jersey', 'Bridgeton') (city) ?	1	1	1	0	0	5	5
3-94704	injuring	city		year	How many people were injured in 2014 (year) in ('Florida', 'Miami') (city) ?	5	6	5	1	0	12	18
3-92524	killing	state	last		How many people were killed in ('Texas',) (state) that involve the name Young (last) ?	2	2	2	0	0	0	2
3-101827	injuring		last	month	How many people were injured in 07/2014 (month) that involve the name Burse (last) ?	2	0	0	0	2	1	0
3-94709	injuring	city		year	How many people were injured in 2014 (year) in ('California', 'Pomona') (city) ?	1	0	0	0	1	5	0
3-94708	injuring	city		year	How many people were injured in 2016 (year) in ('Texas', 'Lufkin') (city) ?	1	0	0	0	1	1	0
3-109319	injuring	city	full_name		How many people were injured in ('Louisiana', 'Baton Rouge') (city) that involve the name Javonte Miles (full_name) ?	1	0	0	0	1	0	0
3-101825	injuring		last	month	How many people were injured in 09/2016 (month) that involve the name McKnight (last) ?	1	1	1	0	0	0	6
3-75197	killing	city		year	How many people were killed in 2016 (year) in ('Iowa', 'Cedar Rapids') (city) ?	7	4	4	0	3	3	2
3-81868	killing		last	year	How many people were killed in 2015 (year) that involve the name Davis (last) ?	5	5	2	3	3	2	1
3-81861	killing		last	year	How many people were killed in 2016 (year) that involve the name Morris (last) ?	4	4	4	0	0	1	2
3-99160	injuring	city		day	How many people were injured in 11/11/2016 (day) in ('Texas', 'Houston') (city) ?	2	2	2	0	0	4	6
3-82710	killing		last	year	How many people were killed in 2016 (year) that involve the name Green (last) ?	9	9	7	2	2	1	15
3-77370	killing	city		month	How many people were killed in 11/2016 (month) in ('California', 'Sacramento') (city) ?	3	3	3	0	0	2	3
3-77371	killing	city		month	How many people were killed in 02/2016 (month) in ('Florida', 'Miami') (city) ?	2	3	2	1	0	1	2
3-76041	killing	state		month	How many people were killed in 12/2014 (month) in ('Michigan',) (state) ?	4	1	1	0	3	3	0
3-77372	killing	city		month	How many people were killed in 06/2016 (month) in ('Ohio', 'Hillsboro') (city) ?	1	0	0	0	1	2	0
3-106285	injuring		first	day	How many people were injured in 11/08/2016 (day) that involve the name Mahaj (first) ?	2	1	1	0	1	1	0
3-82717	killing		last	year	How many people were killed in 2015 (year) that involve the name Walker (last) ?	4	7	4	3	0	3	5
3-93860	injuring	state		day	How many people were injured in 20/04/2014 (day) in ('Illinois',) (state) ?	3	0	0	0	3	11	0
3-75199	killing	city		year	How many people were killed in 2016 (year) in ('Georgia', 'Brunswick') (city) ?	1	0	0	0	1	2	0
3-106271	injuring		first	day	How many people were injured in 23/05/2014 (day) that involve the name Elliot (first) ?	3	3	3	0	0	0	6
3-109781	injuring	city	last		How many people were injured in ('Pennsylvania', 'Pittsburgh') (city) that involve the name Jackson (last) ?	6	3	3	0	3	0	4
3-93843	injuring	state		day	How many people were injured in 15/09/2013 (day) in ('Colorado',) (state) ?	1	0	0	0	1	5	0
3-101814	injuring		last	month	How many people were injured in 06/2016 (month) that involve the name Brown (last) ?	9	5	5	0	4	2	4
3-99153	injuring	city		day	How many people were injured in 12/10/2014 (day) in ('Georgia', 'Atlanta') (city) ?	2	0	0	0	2	3	0
3-82725	killing		last	year	How many people were killed in 2016 (year) that involve the name Dawson (last) ?	2	2	2	0	0	1	1
3-76054	killing	state		month	How many people were killed in 03/2015 (month) in ('New Hampshire',) (state) ?	2	2	2	0	0	3	6
3-89332	killing	city	last		How many people were killed in ('Michigan', 'Detroit') (city) that involve the name Yancy (last) ?	3	0	0	0	3	0	0
3-87155	killing		last	month	How many people were killed in 07/2015 (month) that involve the name Mitchell (last) ?	6	1	1	0	5	1	2
3-101852	injuring		last	month	How many people were injured in 06/2016 (month) that involve the name Watkins (last) ?	1	1	1	0	0	1	2
3-98295	injuring	state		month	How many people were injured in 08/2016 (month) in ('Florida',) (state) ?	4	4	3	1	1	9	3
3-99144	injuring	city		day	How many people were injured in 20/08/2016 (day) in ('North Carolina', 'Durham') (city) ?	2	0	0	0	2	3	0
3-76026	killing	state		month	How many people were killed in 11/2016 (month) in ('Colorado',) (state) ?	5	7	5	2	0	3	6
3-98291	injuring	state		month	How many people were injured in 03/2016 (month) in ('Georgia',) (state) ?	7	6	4	2	3	10	10
3-77359	killing	city		month	How many people were killed in 03/2016 (month) in ('Texas', 'San Antonio') (city) ?	2	2	2	0	0	2	3
3-81841	killing		last	year	How many people were killed in 2014 (year) that involve the name Williams (last) ?	4	9	4	5	0	2	17
3-99149	injuring	city		day	How many people were injured in 23/01/2015 (day) in ('Massachusetts', 'Boston') (city) ?	2	2	2	0	0	6	6
3-98298	injuring	state		month	How many people were injured in 09/2014 (month) in ('Michigan',) (state) ?	2	0	0	0	2	7	0
3-76021	killing	state		month	How many people were killed in 03/2016 (month) in ('Montana',) (state) ?	3	3	2	1	1	5	2
3-106292	injuring		first	day	How many people were injured in 20/02/2016 (day) that involve the name Roy (first) ?	2	2	2	0	0	0	1
3-106291	injuring		first	day	How many people were injured in 08/05/2015 (day) that involve the name Christopher (first) ?	3	1	1	0	2	0	0
3-90312	killing	state	full_name		How many people were killed in ('Louisiana',) (state) that involve the name Devin Anderson (full_name) ?	2	0	0	0	2	1	0
3-110791	injuring	state	full_name		How many people were injured in ('Kentucky',) (state) that involve the name Darren Johnson (full_name) ?	1	1	1	0	0	0	3
3-110795	injuring	state	full_name		How many people were injured in ('Texas',) (state) that involve the name Adrian Garcia-Guevara (full_name) ?	1	1	1	0	0	0	0
3-91648	killing	city	first		How many people were killed in ('Connecticut', 'Waterbury') (city) that involve the name Erick (first) ?	3	0	0	0	3	0	0
3-100502	injuring		first	year	How many people were injured in 2015 (year) that involve the name Brandon (first) ?	3	4	2	2	1	0	4
3-100989	injuring		first	month	How many people were injured in 08/2015 (month) that involve the name Larry (first) ?	1	0	0	0	1	0	0
3-101835	injuring		last	month	How many people were injured in 07/2015 (month) that involve the name Britton (last) ?	2	0	0	0	2	1	0
3-98284	injuring	state		month	How many people were injured in 10/2013 (month) in ('Connecticut',) (state) ?	4	3	3	0	1	5	10
3-100510	injuring		first	year	How many people were injured in 2013 (year) that involve the name Michael (first) ?	4	13	4	9	0	0	31
3-75181	killing	city		year	How many people were killed in 2016 (year) in ('Oregon', 'Woodburn') (city) ?	3	1	1	0	2	3	2
3-80523	killing		first	day	How many people were killed in 17/10/2015 (day) that involve the name Kyle (first) ?	2	0	0	0	2	1	0
3-81853	killing		last	year	How many people were killed in 2016 (year) that involve the name Stewart (last) ?	9	4	4	0	5	0	0
3-110787	injuring	state	full_name		How many people were injured in ('New Jersey',) (state) that involve the name Nina Green (full_name) ?	1	1	1	0	0	1	3
3-89793	killing	city	full_name		How many people were killed in ('Texas', 'Katy') (city) that involve the name Thomas Meisenheimer (full_name) ?	2	1	1	0	1	0	0
3-86283	killing		first	year	How many people were killed in 2016 (year) that involve the name Kevin (first) ?	7	15	4	11	3	0	15
3-91636	killing	city	first		How many people were killed in ('South Carolina', 'Anderson') (city) that involve the name Sarah (first) ?	2	1	0	1	2	1	2
3-93811	injuring	state		day	How many people were injured in 26/12/2015 (day) in ('Pennsylvania',) (state) ?	2	2	2	0	0	4	4
3-77329	killing	city		month	How many people were killed in 12/2015 (month) in ('Nebraska', 'Omaha') (city) ?	1	0	0	0	1	2	0
3-105826	injuring		last	day	How many people were injured in 21/09/2016 (day) that involve the name Phillips (last) ?	1	0	0	0	1	0	0
3-104504	injuring		full_name	year	How many people were injured in 2014 (year) that involve the name Porshia Malone (full_name) ?	2	2	2	0	0	0	1
3-103658	injuring		last	year	How many people were injured in 2016 (year) that involve the name Simmons (last) ?	3	5	3	2	0	0	12
3-104505	injuring		full_name	year	How many people were injured in 2014 (year) that involve the name Vincent Dipina (full_name) ?	1	1	1	0	0	0	3
3-75152	killing	city		year	How many people were killed in 2016 (year) in ('Louisiana', 'Baton Rouge') (city) ?	6	3	2	1	4	6	3
3-81822	killing		last	year	How many people were killed in 2016 (year) that involve the name Arter (last) ?	1	1	1	0	0	2	2
3-76004	killing	state		month	How many people were killed in 08/2016 (month) in ('New Jersey',) (state) ?	5	1	1	0	4	2	0
3-99121	injuring	city		day	How many people were injured in 19/01/2015 (day) in ('Texas', 'San Antonio') (city) ?	6	2	2	0	4	5	2
3-76005	killing	state		month	How many people were killed in 09/2016 (month) in ('Michigan',) (state) ?	9	6	5	1	4	4	11
3-79516	killing		first	month	How many people were killed in 09/2015 (month) that involve the name Steve (first) ?	1	2	1	1	0	1	0
3-99129	injuring	city		day	How many people were injured in 13/01/2015 (day) in ('Virginia', 'Portsmouth') (city) ?	1	1	1	0	0	5	5
3-98277	injuring	state		month	How many people were injured in 07/2014 (month) in ('Virginia',) (state) ?	2	1	1	0	1	12	0
3-91623	killing	city	first		How many people were killed in ('Illinois', 'Chicago') (city) that involve the name Dwight (first) ?	5	0	0	0	5	0	0
3-93800	injuring	state		day	How many people were injured in 22/08/2015 (day) in ('Florida',) (state) ?	1	1	1	0	0	4	0
3-93806	injuring	state		day	How many people were injured in 07/06/2016 (day) in ('Kansas',) (state) ?	1	0	0	0	1	1	0
3-103639	injuring		last	year	How many people were injured in 2016 (year) that involve the name Watkins (last) ?	2	7	2	5	0	2	8
3-102306	injuring		last	month	How many people were injured in 10/2016 (month) that involve the name Davis (last) ?	6	4	3	1	3	2	16
3-75164	killing	city		year	How many people were killed in 2015 (year) in ('Alabama', 'Cherokee (county)') (city) ?	1	0	0	0	1	3	0
3-99593	injuring	city		day	How many people were injured in 19/09/2015 (day) in ('Indiana', 'Indianapolis') (city) ?	3	0	0	0	3	3	0
3-103644	injuring		last	year	How many people were injured in 2016 (year) that involve the name McCray (last) ?	10	11	8	3	2	0	22
3-81834	killing		last	year	How many people were killed in 2016 (year) that involve the name Marrero (last) ?	4	4	2	2	2	0	0
3-76016	killing	state		month	How many people were killed in 09/2016 (month) in ('South Carolina',) (state) ?	5	4	2	2	3	3	1
3-102793	injuring		full_name	month	How many people were injured in 05/2016 (month) that involve the name Da'deron Johnson (full_name) ?	2	0	0	0	2	0	0
3-76017	killing	state		month	How many people were killed in 03/2014 (month) in ('Alabama',) (state) ?	1	0	0	0	1	1	0
3-99590	injuring	city		day	How many people were injured in 05/11/2016 (day) in ('Texas', 'San Antonio') (city) ?	2	2	2	0	0	4	4
3-99116	injuring	city		day	How many people were injured in 05/07/2015 (day) in ('Indiana', 'Fort Wayne') (city) ?	2	0	0	0	2	9	0
3-99119	injuring	city		day	How many people were injured in 03/05/2015 (day) in ('Iowa', 'Iowa City') (city) ?	1	1	1	0	0	1	0
3-75168	killing	city		year	How many people were killed in 2016 (year) in ('Alabama', 'Mobile') (city) ?	3	0	0	0	3	2	0
3-96087	injuring	city		month	How many people were injured in 10/2015 (month) in ('South Carolina', 'Bamberg') (city) ?	1	0	0	0	1	4	0
3-99596	injuring	city		day	How many people were injured in 17/03/2015 (day) in ('California', 'Stockton') (city) ?	2	0	0	0	2	4	0
3-98268	injuring	state		month	How many people were injured in 06/2016 (month) in ('Wisconsin',) (state) ?	1	1	0	1	1	2	2
3-76011	killing	state		month	How many people were killed in 10/2016 (month) in ('Arkansas',) (state) ?	3	3	2	1	1	2	0
3-111297	job_firing	state		month	How many people were fired in 07/2013 (month) in ('Maryland',) (state) ?	3	0	0	0	3	1	0
3-92945	killing	state	last		How many people were killed in ('South Carolina',) (state) that involve the name Scott (last) ?	1	2	1	1	0	3	2
3-87113	killing		last	month	How many people were killed in 02/2015 (month) that involve the name Gilliam (last) ?	3	0	0	0	3	0	0
3-101008	injuring		first	month	How many people were injured in 07/2014 (month) that involve the name Cedric (first) ?	1	1	1	0	0	0	3
3-84086	killing		full_name	month	How many people were killed in 12/2015 (month) that involve the name Kaitlyn Pullam (full_name) ?	3	0	0	0	3	1	0
3-86265	killing		first	year	How many people were killed in 2016 (year) that involve the name Patricia (first) ?	1	3	1	2	0	0	7
3-100168	injuring		first	year	How many people were injured in 2016 (year) that involve the name Edward (first) ?	3	6	2	4	1	0	12
3-105858	injuring		last	day	How many people were injured in 30/06/2016 (day) that involve the name Foreman (last) ?	2	1	1	0	1	0	4
3-99100	injuring	city		day	How many people were injured in 02/09/2014 (day) in ('Mississippi', 'Jackson') (city) ?	1	0	0	0	1	3	0
3-98252	injuring	state		month	How many people were injured in 11/2015 (month) in ('Connecticut',) (state) ?	2	2	1	1	1	2	5
3-100164	injuring		first	year	How many people were injured in 2016 (year) that involve the name Reginald (first) ?	4	6	4	2	0	0	8
3-101012	injuring		first	month	How many people were injured in 11/2015 (month) that involve the name Brandon (first) ?	1	2	1	1	0	0	0
3-76467	killing	state		day	How many people were killed in 10/04/2016 (day) in ('Wisconsin',) (state) ?	1	2	1	1	0	1	1
3-96070	injuring	city		month	How many people were injured in 04/2015 (month) in ('North Carolina', 'Raleigh') (city) ?	3	3	3	0	0	1	0
3-96071	injuring	city		month	How many people were injured in 10/2013 (month) in ('Florida', 'Miami Gardens') (city) ?	1	1	1	0	0	4	0
3-98259	injuring	state		month	How many people were injured in 10/2015 (month) in ('Georgia',) (state) ?	3	0	0	0	3	2	0
3-99108	injuring	city		day	How many people were injured in 18/04/2016 (day) in ('Wisconsin', 'Milwaukee') (city) ?	1	1	1	0	0	2	0
3-77790	killing	city		month	How many people were killed in 03/2016 (month) in ('Montana', 'Roundup') (city) ?	2	2	2	0	0	2	0
3-99101	injuring	city		day	How many people were injured in 18/12/2016 (day) in ('Mississippi', 'Raymond') (city) ?	1	0	0	0	1	2	0
3-98257	injuring	state		month	How many people were injured in 04/2015 (month) in ('Idaho',) (state) ?	1	1	1	0	0	1	0
3-99104	injuring	city		day	How many people were injured in 21/10/2016 (day) in ('Pennsylvania', 'Pittsburgh') (city) ?	2	3	2	1	0	1	11
3-99588	injuring	city		day	How many people were injured in 07/07/2016 (day) in ('Louisiana', 'Baton Rouge') (city) ?	2	1	1	0	1	4	4
3-99587	injuring	city		day	How many people were injured in 16/07/2016 (day) in ('California', 'San Bernardino') (city) ?	1	0	0	0	1	4	0
3-111289	job_firing	state		month	How many people were fired in 09/2015 (month) in ('Texas',) (state) ?	8	1	1	0	7	0	0
3-87128	killing		last	month	How many people were killed in 12/2016 (month) that involve the name Kirkpatrick (last) ?	1	1	1	0	0	1	0
3-77319	killing	city		month	How many people were killed in 01/2015 (month) in ('California', 'San Francisco') (city) ?	2	2	2	0	0	4	8
3-86279	killing		first	year	How many people were killed in 2016 (year) that involve the name William (first) ?	7	12	4	8	3	1	4
3-87125	killing		last	month	How many people were killed in 08/2016 (month) that involve the name Covey (last) ?	4	1	1	0	3	0	1
3-92939	killing	state	last		How many people were killed in ('Illinois',) (state) that involve the name Agnew (last) ?	2	2	2	0	0	1	2
3-103668	injuring		last	year	How many people were injured in 2016 (year) that involve the name Ruffin (last) ?	3	2	2	0	1	2	2
3-81810	killing		last	year	How many people were killed in 2015 (year) that involve the name Taylor (last) ?	4	5	3	2	1	2	5
3-77322	killing	city		month	How many people were killed in 06/2016 (month) in ('Texas', 'Aransas Pass') (city) ?	3	0	0	0	3	3	0
3-100159	injuring		first	year	How many people were injured in 2016 (year) that involve the name Timothy (first) ?	7	9	4	5	3	0	15
3-103666	injuring		last	year	How many people were injured in 2016 (year) that involve the name Crawford (last) ?	1	2	1	1	0	0	0
3-99572	injuring	city		day	How many people were injured in 09/10/2016 (day) in ('California', 'Sacramento') (city) ?	1	0	0	0	1	3	0
3-80966	killing		full_name	year	How many people were killed in 2016 (year) that involve the name Stanley Dixon (full_name) ?	1	1	1	0	0	0	0
3-100154	injuring		first	year	How many people were injured in 2015 (year) that involve the name Jonathon (first) ?	3	0	0	0	3	0	0
3-103665	injuring		last	year	How many people were injured in 2016 (year) that involve the name Powell (last) ?	2	4	1	3	1	1	2
3-105842	injuring		last	day	How many people were injured in 01/09/2015 (day) that involve the name Smith (last) ?	1	1	1	0	0	0	0
3-101003	injuring		first	month	How many people were injured in 12/2015 (month) that involve the name Shane (first) ?	1	1	1	0	0	0	3
3-96060	injuring	city		month	How many people were injured in 03/2016 (month) in ('Virginia', 'Annandale') (city) ?	1	0	0	0	1	1	0
3-99579	injuring	city		day	How many people were injured in 15/06/2013 (day) in ('Rhode Island', 'Providence') (city) ?	2	0	0	0	2	3	0
3-98244	injuring	state		month	How many people were injured in 07/2016 (month) in ('California',) (state) ?	6	2	2	0	4	17	10
3-96067	injuring	city		month	How many people were injured in 07/2013 (month) in ('California', 'San Francisco') (city) ?	2	2	2	0	0	3	4
3-98246	injuring	state		month	How many people were injured in 02/2015 (month) in ('California',) (state) ?	5	4	4	0	1	10	7
3-98245	injuring	state		month	How many people were injured in 11/2016 (month) in ('Connecticut',) (state) ?	3	4	2	2	1	6	3
3-108065	injuring	state	first		How many people were injured in ('California',) (state) that involve the name Courtney (first) ?	5	4	4	0	1	0	1
3-86240	killing		first	year	How many people were killed in 2016 (year) that involve the name Michael (first) ?	6	39	6	33	0	3	37
3-109397	injuring	city	full_name		How many people were injured in ('Michigan', 'Detroit') (city) that involve the name Torrey Craft (full_name) ?	3	1	1	0	2	0	0
3-84062	killing		full_name	month	How many people were killed in 07/2016 (month) that involve the name Clayton Brumby (full_name) ?	2	1	1	0	1	0	0
3-75108	killing	city		year	How many people were killed in 2016 (year) in ('Tennessee', 'Knoxville') (city) ?	3	1	0	1	3	2	2
3-103606	injuring		last	year	How many people were injured in 2015 (year) that involve the name Black (last) ?	1	1	1	0	0	0	1
3-102757	injuring		full_name	month	How many people were injured in 02/2013 (month) that involve the name Oscar Garcia (full_name) ?	3	2	2	0	1	0	3
3-99560	injuring	city		day	How many people were injured in 01/01/2016 (day) in ('Florida', 'Orlando') (city) ?	1	0	0	0	1	1	0
3-77773	killing	city		month	How many people were killed in 07/2016 (month) in ('Texas', 'Houston') (city) ?	9	8	8	0	1	6	14
3-96051	injuring	city		month	How many people were injured in 04/2016 (month) in ('Wisconsin', 'Milwaukee') (city) ?	2	3	2	1	0	5	3
3-100104	injuring		first	year	How many people were injured in 2014 (year) that involve the name Kevin (first) ?	2	4	2	2	0	0	6
3-99562	injuring	city		day	How many people were injured in 08/08/2016 (day) in ('Texas', 'Houston') (city) ?	1	0	0	0	1	1	0
3-77775	killing	city		month	How many people were killed in 08/2013 (month) in ('Missouri', 'Saint Louis') (city) ?	2	2	2	0	0	2	4
3-100583	injuring		first	year	How many people were injured in 2015 (year) that involve the name Michael (first) ?	3	35	3	32	0	1	53
3-103610	injuring		last	year	How many people were injured in 2016 (year) that involve the name Hines (last) ?	4	5	3	2	1	0	10
3-102763	injuring		full_name	month	How many people were injured in 12/2016 (month) that involve the name Linda Hall (full_name) ?	1	1	1	0	0	0	4
3-98237	injuring	state		month	How many people were injured in 07/2016 (month) in ('New York',) (state) ?	9	0	0	0	9	13	0
3-75116	killing	city		year	How many people were killed in 2016 (year) in ('California', 'Fresno') (city) ?	1	3	1	2	0	1	1
3-98236	injuring	state		month	How many people were injured in 05/2016 (month) in ('California',) (state) ?	2	3	2	1	0	8	3
3-109391	injuring	city	full_name		How many people were injured in ('California', 'San Francisco') (city) that involve the name Verle Jones (full_name) ?	2	1	1	0	1	0	8
3-75112	killing	city		year	How many people were killed in 2016 (year) in ('Arkansas', 'Beebe') (city) ?	1	1	1	0	0	1	1
3-96056	injuring	city		month	How many people were injured in 10/2016 (month) in ('Arizona', 'Peoria') (city) ?	1	1	1	0	0	2	0
3-75594	killing	city		day	How many people were killed in 19/09/2015 (day) in ('Indiana', 'Indianapolis') (city) ?	3	0	0	0	3	1	0
3-98219	injuring	state		month	How many people were injured in 10/2016 (month) in ('Nevada',) (state) ?	3	1	1	0	2	3	0
3-75119	killing	city		year	How many people were killed in 2016 (year) in ('Connecticut', 'Bristol') (city) ?	2	0	0	0	2	1	0
3-86253	killing		first	year	How many people were killed in 2015 (year) that involve the name Michael (first) ?	7	19	5	14	2	3	27
3-88432	killing	state	first		How many people were killed in ('Tennessee',) (state) that involve the name Robert (first) ?	4	6	2	4	2	1	8
3-101417	injuring		first	month	How many people were injured in 11/2016 (month) that involve the name Richard (first) ?	3	2	1	1	2	0	6
3-75120	killing	city		year	How many people were killed in 2015 (year) in ('Florida', 'Panama City') (city) ?	1	0	0	0	1	1	0
3-101425	injuring		first	month	How many people were injured in 05/2015 (month) that involve the name Darnell (first) ?	2	1	1	0	1	0	0
3-99551	injuring	city		day	How many people were injured in 04/07/2015 (day) in ('Kentucky', 'Louisville') (city) ?	2	0	0	0	2	4	0
3-98228	injuring	state		month	How many people were injured in 12/2016 (month) in ('North Dakota',) (state) ?	1	1	1	0	0	1	0
3-99559	injuring	city		day	How many people were injured in 05/07/2015 (day) in ('Ohio', 'Cincinnati') (city) ?	1	1	1	0	0	1	0
3-100570	injuring		first	year	How many people were injured in 2016 (year) that involve the name David (first) ?	6	37	5	32	1	1	37
3-99558	injuring	city		day	How many people were injured in 23/07/2015 (day) in ('Ohio', 'Pike (county)') (city) ?	1	0	0	0	1	1	0
3-99553	injuring	city		day	How many people were injured in 13/03/2015 (day) in ('Mississippi', 'Brookhaven') (city) ?	2	0	0	0	2	3	0
3-98221	injuring	state		month	How many people were injured in 05/2013 (month) in ('Pennsylvania',) (state) ?	3	2	2	0	1	8	4
3-96046	injuring	city		month	How many people were injured in 07/2016 (month) in ('Maryland', 'Baltimore') (city) ?	3	1	0	1	3	9	0
3-108088	injuring	state	first		How many people were injured in ('Indiana',) (state) that involve the name Justin (first) ?	4	3	3	0	1	0	2
3-87550	killing		last	month	How many people were killed in 07/2016 (month) that involve the name Salas (last) ?	1	1	1	0	0	0	0
3-111252	injuring	state	full_name		How many people were injured in ('Virginia',) (state) that involve the name Bradley Shines (full_name) ?	1	1	1	0	0	0	0
3-85371	killing		full_name	day	How many people were killed in 12/12/2016 (day) that involve the name Ibn Perry (full_name) ?	2	2	2	0	0	1	0
3-90720	killing	state	full_name		How many people were killed in ('Louisiana',) (state) that involve the name Sirdetrick Samuels (full_name) ?	1	1	1	0	0	0	0
3-74238	killing	state		year	How many people were killed in 2016 (year) in ('Wisconsin',) (state) ?	16	21	11	10	5	13	20
3-92904	killing	state	last		How many people were killed in ('Florida',) (state) that involve the name Payne (last) ?	2	1	0	1	2	0	0
3-86224	killing		first	year	How many people were killed in 2015 (year) that involve the name Brandon (first) ?	3	4	2	2	1	2	6
3-90727	killing	state	full_name		How many people were killed in ('Alabama',) (state) that involve the name Lionel Francis (full_name) ?	1	1	1	0	0	0	0
3-100118	injuring		first	year	How many people were injured in 2015 (year) that involve the name Nicholas (first) ?	4	4	4	0	0	3	6
3-84045	killing		full_name	month	How many people were killed in 04/2016 (month) that involve the name Branden Davis (full_name) ?	1	1	1	0	0	0	1
3-86220	killing		first	year	How many people were killed in 2016 (year) that involve the name Javante (first) ?	3	0	0	0	3	1	0
3-100124	injuring		first	year	How many people were injured in 2016 (year) that involve the name Christopher (first) ?	7	31	6	25	1	0	26
3-98690	injuring	state		month	How many people were injured in 08/2015 (month) in ('Connecticut',) (state) ?	1	0	0	0	1	1	0
3-99540	injuring	city		day	How many people were injured in 17/07/2016 (day) in ('Texas', 'Houston') (city) ?	1	1	1	0	0	3	3
3-79932	killing		first	day	How many people were killed in 13/10/2015 (day) that involve the name Brian (first) ?	1	1	1	0	0	1	0
3-86218	killing		first	year	How many people were killed in 2016 (year) that involve the name Gavin (first) ?	7	3	3	0	4	3	0
3-75579	killing	city		day	How many people were killed in 22/09/2013 (day) in ('Kansas', 'Wichita') (city) ?	2	1	1	0	1	1	1
3-98699	injuring	state		month	How many people were injured in 09/2013 (month) in ('Kansas',) (state) ?	2	1	1	0	1	6	7
3-96037	injuring	city		month	How many people were injured in 07/2016 (month) in ('Virginia', 'Norfolk') (city) ?	1	1	1	0	0	1	0
3-101450	injuring		first	month	How many people were injured in 04/2016 (month) that involve the name Edwin (first) ?	3	1	1	0	2	0	3
3-98217	injuring	state		month	How many people were injured in 02/2016 (month) in ('Michigan',) (state) ?	4	1	1	0	3	6	0
3-98216	injuring	state		month	How many people were injured in 03/2015 (month) in ('New Jersey',) (state) ?	1	0	0	0	1	3	0
3-98694	injuring	state		month	How many people were injured in 09/2014 (month) in ('California',) (state) ?	3	2	1	1	2	12	7
3-108085	injuring	state	first		How many people were injured in ('Georgia',) (state) that involve the name Shareen (first) ?	2	2	2	0	0	1	4
3-98212	injuring	state		month	How many people were injured in 07/2015 (month) in ('Ohio',) (state) ?	4	5	2	3	2	9	5
3-99527	injuring	city		day	How many people were injured in 08/01/2015 (day) in ('Massachusetts', 'Boston') (city) ?	2	1	1	0	1	3	0
3-99529	injuring	city		day	How many people were injured in 09/04/2016 (day) in ('New Mexico', 'Albuquerque') (city) ?	1	1	1	0	0	4	4
3-16	injuring	city		day	How many people were injured in 15/11/2007 (day) in ('Georgia', 'Savannah') (city) ?	0	0	0	0	0	0	0
3-15	injuring	city		day	How many people were injured in 24/07/2016 (day) in ('Missouri', 'Saint Louis') (city) ?	0	0	0	0	0	0	0
3-87569	killing		last	month	How many people were killed in 06/2016 (month) that involve the name Harewood (last) ?	1	1	1	0	0	1	2
3-14	killing	city		day	How many people were killed in 05/11/2016 (day) in ('Texas', 'Dallas') (city) ?	0	0	0	0	0	0	0
3-76429	killing	state		day	How many people were killed in 02/07/2016 (day) in ('Indiana',) (state) ?	4	2	2	0	2	2	2
3-13	injuring	city		day	How many people were injured in 10/12/2016 (day) in ('Kansas', 'Wichita') (city) ?	0	0	0	0	0	0	0
3-12	killing	city		day	How many people were killed in 04/08/2016 (day) in ('Illinois', 'Calumet City') (city) ?	0	0	0	0	0	0	0
3-103618	injuring		last	year	How many people were injured in 2016 (year) that involve the name Long (last) ?	3	5	2	3	1	0	3
3-11	injuring	city		day	How many people were injured in 25/02/2015 (day) in ('California', 'Los Angeles') (city) ?	0	0	0	0	0	0	0
3-10	killing	city		day	How many people were killed in 23/07/2015 (day) in ('Arkansas', 'Eudora') (city) ?	0	0	0	0	0	0	0
3-87562	killing		last	month	How many people were killed in 11/2016 (month) that involve the name Cervantes (last) ?	1	1	1	0	0	2	0
3-77761	killing	city		month	How many people were killed in 04/2015 (month) in ('Florida', 'Fort Pierce') (city) ?	1	0	0	0	1	1	0
3-100114	injuring		first	year	How many people were injured in 2016 (year) that involve the name James (first) ?	7	39	5	34	2	1	23
3-100598	injuring		first	year	How many people were injured in 2016 (year) that involve the name Jacob (first) ?	10	11	4	7	6	2	2
3-77767	killing	city		month	How many people were killed in 09/2016 (month) in ('California', 'Rosamond') (city) ?	1	0	0	0	1	1	0
3-98688	injuring	state		month	How many people were injured in 11/2016 (month) in ('Louisiana',) (state) ?	11	10	8	2	3	10	26
3-75105	killing	city		year	How many people were killed in 2015 (year) in ('Louisiana', 'Baton Rouge') (city) ?	5	3	3	0	2	4	3
3-96026	injuring	city		month	How many people were injured in 08/2016 (month) in ('Virginia', 'Newport News') (city) ?	4	0	0	0	4	3	0
3-75102	killing	city		year	How many people were killed in 2016 (year) in ('Georgia', 'Norcross') (city) ?	2	0	0	0	2	4	0
3-98684	injuring	state		month	How many people were injured in 02/2015 (month) in ('Mississippi',) (state) ?	1	1	1	0	0	1	0
3-75584	killing	city		day	How many people were killed in 14/03/2016 (day) in ('West Virginia', 'Beckley') (city) ?	1	0	0	0	1	1	0
3-98686	injuring	state		month	How many people were injured in 09/2016 (month) in ('California',) (state) ?	3	6	3	3	0	5	8
3-98685	injuring	state		month	How many people were injured in 10/2016 (month) in ('Louisiana',) (state) ?	4	8	4	4	0	6	14
3-83290	killing		last	day	How many people were killed in 25/11/2016 (day) that involve the name Hutton (last) ?	3	2	2	0	1	3	5
3-108940	injuring	state	last		How many people were injured in ('Illinois',) (state) that involve the name Williams (last) ?	2	5	1	4	1	0	12
3-90821	killing	state	full_name		How many people were killed in ('Ohio',) (state) that involve the name Tyre King (full_name) ?	2	1	1	0	1	1	0
3-27	injuring	city		day	How many people were injured in 30/01/2016 (day) in ('Ohio', 'Dayton') (city) ?	0	0	0	0	0	0	0
3-88504	killing	state	first		How many people were killed in ('Pennsylvania',) (state) that involve the name Ciara (first) ?	8	1	1	0	7	1	0
3-26	killing	city		day	How many people were killed in 16/01/2016 (day) in ('Montana', 'Bozeman') (city) ?	0	0	0	0	0	0	0
3-76516	killing	state		day	How many people were killed in 18/11/2016 (day) in ('Georgia',) (state) ?	1	1	1	0	0	3	0
3-85476	killing		full_name	day	How many people were killed in 20/10/2016 (day) that involve the name Leonard Moses (full_name) ?	2	1	1	0	1	1	1
3-25	injuring	city		day	How many people were injured in 09/04/2016 (day) in ('Missouri', 'Eureka') (city) ?	0	0	0	0	0	0	0
3-24	injuring	city		day	How many people were injured in 24/09/2006 (day) in ('Louisiana', 'Baton Rouge') (city) ?	0	0	0	0	0	0	0
3-88501	killing	state	first		How many people were killed in ('Kansas',) (state) that involve the name Lily (first) ?	2	1	1	0	1	1	0
3-89832	killing	city	full_name		How many people were killed in ('Oklahoma', 'Tulsa') (city) that involve the name Chaz Fain (full_name) ?	2	1	1	0	1	1	0
3-23	killing	city		day	How many people were killed in 08/03/2016 (day) in ('Maryland', 'Baltimore') (city) ?	0	0	0	0	0	0	0
3-90828	killing	state	full_name		How many people were killed in ('Alabama',) (state) that involve the name Joseph Lewis (full_name) ?	2	0	0	0	2	0	0
3-107616	injuring	state	first		How many people were injured in ('California',) (state) that involve the name Bernard (first) ?	1	0	0	0	1	0	0
3-22	injuring	city		day	How many people were injured in 08/11/2016 (day) in ('New Jersey', 'Trenton') (city) ?	0	0	0	0	0	0	0
3-21	injuring	city		day	How many people were injured in 19/04/2015 (day) in ('Texas', 'Houston') (city) ?	0	0	0	0	0	0	0
3-88982	killing	city	last		How many people were killed in ('Arizona', 'Tucson') (city) that involve the name Carrillo (last) ?	1	0	0	0	1	3	0
3-20	injuring	city		day	How many people were injured in 10/04/2016 (day) in ('Pennsylvania', 'Erie') (city) ?	0	0	0	0	0	0	0
3-98790	injuring	state		year	How many people were injured in 2014 (year) in ('Wisconsin',) (state) ?	2	4	2	2	0	5	6
3-104109	injuring		last	year	How many people were injured in 2013 (year) that involve the name Montgomery (last) ?	6	0	0	0	6	0	0
3-98792	injuring	state		year	How many people were injured in 2014 (year) in ('California',) (state) ?	26	23	21	2	5	100	72
3-98791	injuring	state		year	How many people were injured in 2016 (year) in ('Kentucky',) (state) ?	10	11	6	5	4	9	3
3-19	killing	city		day	How many people were killed in 28/10/2016 (day) in ('Iowa', 'Council Bluffs') (city) ?	0	0	0	0	0	0	0
3-76523	killing	state		day	How many people were killed in 19/11/2014 (day) in ('New Mexico',) (state) ?	2	0	0	0	2	1	0
3-18	killing	city		day	How many people were killed in 23/03/2014 (day) in ('Arizona', 'Phoenix') (city) ?	0	0	0	0	0	0	0
3-105433	injuring		full_name	day	How many people were injured in 01/10/2016 (day) that involve the name Gregory Lambert (full_name) ?	1	1	1	0	0	0	0
3-17	injuring	city		day	How many people were injured in 08/08/2016 (day) in ('Texas', 'Dallas') (city) ?	0	0	0	0	0	0	0
3-98798	injuring	state		year	How many people were injured in 2016 (year) in ('South Carolina',) (state) ?	16	23	11	12	5	15	22
3-98797	injuring	state		year	How many people were injured in 2015 (year) in ('Nevada',) (state) ?	6	6	6	0	0	6	3
3-75676	killing	city		day	How many people were killed in 17/05/2016 (day) in ('South Carolina', 'Ravenel') (city) ?	1	0	0	0	1	3	0
3-106760	injuring		first	day	How many people were injured in 21/08/2015 (day) that involve the name Ty (first) ?	2	0	0	0	2	1	0
3-98315	injuring	state		month	How many people were injured in 04/2016 (month) in ('California',) (state) ?	7	7	3	4	4	16	14
3-98799	injuring	state		year	How many people were injured in 2013 (year) in ('Maryland',) (state) ?	10	9	8	1	2	16	32
3-99646	injuring	city		day	How many people were injured in 27/12/2016 (day) in ('Wisconsin', 'Milwaukee') (city) ?	1	1	1	0	0	1	1
3-98794	injuring	state		year	How many people were injured in 2016 (year) in ('Texas',) (state) ?	121	162	98	64	23	113	171
3-98793	injuring	state		year	How many people were injured in 2013 (year) in ('Ohio',) (state) ?	4	7	2	5	2	12	16
3-96133	injuring	city		month	How many people were injured in 06/2016 (month) in ('Michigan', 'Redford') (city) ?	1	1	0	1	1	1	0
3-98796	injuring	state		year	How many people were injured in 2015 (year) in ('Utah',) (state) ?	4	4	2	2	2	2	1
3-98795	injuring	state		year	How many people were injured in 2014 (year) in ('Illinois',) (state) ?	15	7	6	1	9	50	21
3-99642	injuring	city		day	How many people were injured in 29/05/2016 (day) in ('New Jersey', 'Trenton') (city) ?	1	1	1	0	0	6	0
3-30	injuring	city		day	How many people were injured in 25/11/2016 (day) in ('Mississippi', 'Guntown') (city) ?	0	0	0	0	0	0	0
3-96117	injuring	city		month	How many people were injured in 05/2016 (month) in ('Tennessee', 'Smyrna') (city) ?	2	0	0	0	2	1	0
3-98779	injuring	state		year	How many people were injured in 2015 (year) in ('North Carolina',) (state) ?	17	19	13	6	4	39	25
3-96119	injuring	city		month	How many people were injured in 11/2015 (month) in ('Georgia', 'Jefferson') (city) ?	1	0	0	0	1	1	0
3-99629	injuring	city		day	How many people were injured in 06/12/2015 (day) in ('Louisiana', 'New Orleans') (city) ?	1	1	1	0	0	1	0
3-38	injuring	city		month	How many people were injured in 02/2016 (month) in ('New Jersey', 'Millville') (city) ?	0	0	0	0	0	0	0
3-107601	injuring	state	first		How many people were injured in ('Massachusetts',) (state) that involve the name Alex (first) ?	2	0	0	0	2	0	0
3-37	injuring	state		month	How many people were injured in 11/2005 (month) in ('California',) (state) ?	0	3	0	3	0	0	0
3-36	killing	state		month	How many people were killed in 02/2016 (month) in ('Oklahoma',) (state) ?	0	0	0	0	0	0	0
3-86334	killing		first	year	How many people were killed in 2015 (year) that involve the name Mark (first) ?	4	12	3	9	1	2	17
3-35	injuring	state		month	How many people were injured in 09/2015 (month) in ('Alabama',) (state) ?	0	1	0	1	0	0	4
3-34	injuring	state		month	How many people were injured in 02/2015 (month) in ('Wisconsin',) (state) ?	0	0	0	0	0	0	0
3-33	injuring	state		month	How many people were injured in 01/2013 (month) in ('New York',) (state) ?	0	0	0	0	0	0	0
3-88510	killing	state	first		How many people were killed in ('South Dakota',) (state) that involve the name Michael (first) ?	2	2	2	0	0	1	10
3-32	injuring	state		month	How many people were injured in 09/2015 (month) in ('New Mexico',) (state) ?	0	0	0	0	0	0	0
3-31	injuring	state		month	How many people were injured in 06/2015 (month) in ('Iowa',) (state) ?	0	0	0	0	0	0	0
3-75680	killing	city		day	How many people were killed in 24/07/2015 (day) in ('Pennsylvania', 'Erie') (city) ?	5	0	0	0	5	2	0
3-98781	injuring	state		year	How many people were injured in 2016 (year) in ('Alaska',) (state) ?	3	5	1	4	2	2	5
3-103247	injuring		full_name	month	How many people were injured in 11/2016 (month) that involve the name Patrick Glenn (full_name) ?	1	0	0	0	1	0	0
3-106754	injuring		first	day	How many people were injured in 28/11/2016 (day) that involve the name Raul (first) ?	1	0	0	0	1	0	0
3-29	injuring	city		day	How many people were injured in 25/08/2016 (day) in ('Maryland', 'Baltimore') (city) ?	0	0	0	0	0	0	0
3-77866	killing	city		month	How many people were killed in 08/2015 (month) in ('Pennsylvania', 'Smicksburg') (city) ?	2	0	0	0	2	2	0
3-93092	killing	state	last		How many people were killed in ('Texas',) (state) that involve the name Stone (last) ?	1	1	1	0	0	4	1
3-28	killing	city		day	How many people were killed in 02/05/2013 (day) in ('California', 'Los Angeles') (city) ?	0	0	0	0	0	0	0
3-98787	injuring	state		year	How many people were injured in 2013 (year) in ('New Jersey',) (state) ?	7	8	6	2	1	25	23
3-99634	injuring	city		day	How many people were injured in 02/07/2016 (day) in ('Texas', 'Waco') (city) ?	1	1	1	0	0	1	0
3-75688	killing	city		day	How many people were killed in 08/11/2016 (day) in ('California', 'Sacramento') (city) ?	1	0	0	0	1	1	0
3-99633	injuring	city		day	How many people were injured in 31/10/2016 (day) in ('Louisiana', 'Shreveport') (city) ?	2	2	2	0	0	4	4
3-98305	injuring	state		month	How many people were injured in 06/2015 (month) in ('Indiana',) (state) ?	2	2	2	0	0	2	0
3-98789	injuring	state		year	How many people were injured in 2014 (year) in ('Tennessee',) (state) ?	9	8	6	2	3	26	19
3-75686	killing	city		day	How many people were killed in 25/02/2015 (day) in ('Texas', 'Houston') (city) ?	1	1	1	0	0	3	0
3-98788	injuring	state		year	How many people were injured in 2013 (year) in ('Rhode Island',) (state) ?	4	2	2	0	2	7	7
3-98783	injuring	state		year	How many people were injured in 2016 (year) in ('Alabama',) (state) ?	10	12	7	5	3	25	31
3-98782	injuring	state		year	How many people were injured in 2016 (year) in ('Maryland',) (state) ?	25	30	15	15	10	50	53
3-98785	injuring	state		year	How many people were injured in 2013 (year) in ('Virginia',) (state) ?	2	2	2	0	0	11	8
3-41	injuring	city		month	How many people were injured in 08/2015 (month) in ('Mississippi', 'Bay St. Louis') (city) ?	0	0	0	0	0	0	0
3-40	injuring	city		month	How many people were injured in 08/2015 (month) in ('Washington', 'Shelton') (city) ?	0	0	0	0	0	0	0
3-81092	killing		full_name	year	How many people were killed in 2016 (year) that involve the name Michael Parsons (full_name) ?	2	2	2	0	0	1	0
3-98769	injuring	state		year	How many people were injured in 2016 (year) in ('Mississippi',) (state) ?	10	11	7	4	3	16	27
3-98768	injuring	state		year	How many people were injured in 2014 (year) in ('Oklahoma',) (state) ?	1	6	1	5	0	4	5
3-49	killing	city		month	How many people were killed in 09/2016 (month) in ('Washington', 'Rock Island') (city) ?	0	0	0	0	0	0	0
3-86787	killing		last	month	How many people were killed in 07/2015 (month) that involve the name Recktenwald (last) ?	1	1	1	0	0	2	0
3-48	injuring	city		month	How many people were injured in 09/2014 (month) in ('North Carolina', 'Rocky Mount') (city) ?	0	0	0	0	0	0	0
3-47	injuring	city		month	How many people were injured in 12/2016 (month) in ('Texas', 'Fresno') (city) ?	0	0	0	0	0	0	0
3-109814	injuring	city	last		How many people were injured in ('California', 'Sacramento') (city) that involve the name Taylor (last) ?	2	0	0	0	2	0	0
3-46	killing	city		month	How many people were killed in 09/2014 (month) in ('Texas', 'Killeen') (city) ?	0	0	0	0	0	0	0
3-108968	injuring	state	last		How many people were injured in ('Pennsylvania',) (state) that involve the name Meyer (last) ?	8	1	1	0	7	0	0
3-45	injuring	city		month	How many people were injured in 05/2015 (month) in ('Montana', 'Roundup') (city) ?	0	0	0	0	0	0	0
3-77828	killing	city		month	How many people were killed in 12/2016 (month) in ('Ohio', 'Columbus') (city) ?	4	1	1	0	3	1	0
3-44	killing	city		month	How many people were killed in 08/2015 (month) in ('Wisconsin', 'Milwaukee') (city) ?	0	0	0	0	0	0	0
3-77829	killing	city		month	How many people were killed in 05/2015 (month) in ('Arizona', 'Tucson') (city) ?	1	0	0	0	1	5	0
3-43	killing	city		month	How many people were killed in 05/2015 (month) in ('Florida', 'Tampa') (city) ?	0	0	0	0	0	0	0
3-85453	killing		full_name	day	How many people were killed in 06/11/2015 (day) that involve the name Jonathan Figueroa (full_name) ?	2	2	2	0	0	0	2
3-42	injuring	city		month	How many people were injured in 04/2016 (month) in ('Michigan', 'Saginaw') (city) ?	0	0	0	0	0	0	0
3-104126	injuring		last	year	How many people were injured in 2016 (year) that involve the name Lee (last) ?	3	8	2	6	1	0	21
3-103277	injuring		full_name	month	How many people were injured in 10/2016 (month) that involve the name Anfernee Olivo (full_name) ?	1	1	1	0	0	0	0
3-39	injuring	city		month	How many people were injured in 10/2016 (month) in ('Texas', 'Carlsbad') (city) ?	0	0	0	0	0	0	0
3-98776	injuring	state		year	How many people were injured in 2014 (year) in ('Texas',) (state) ?	5	14	5	9	0	21	30
3-99623	injuring	city		day	How many people were injured in 06/10/2015 (day) in ('Maryland', 'Baltimore') (city) ?	2	1	1	0	1	5	5
3-98775	injuring	state		year	How many people were injured in 2014 (year) in ('Georgia',) (state) ?	9	14	7	7	2	17	23
3-99622	injuring	city		day	How many people were injured in 24/09/2016 (day) in ('Maryland', 'Baltimore') (city) ?	2	2	2	0	0	8	10
3-96599	injuring	city		month	How many people were injured in 05/2014 (month) in ('California', 'Sacramento') (city) ?	2	2	2	0	0	12	6
3-98778	injuring	state		year	How many people were injured in 2015 (year) in ('Louisiana',) (state) ?	14	26	13	13	1	26	26
3-98772	injuring	state		year	How many people were injured in 2016 (year) in ('Illinois',) (state) ?	91	44	29	15	62	170	84
3-96110	injuring	city		month	How many people were injured in 02/2016 (month) in ('Florida', 'Palatka') (city) ?	1	0	0	0	1	1	0
3-98771	injuring	state		year	How many people were injured in 2014 (year) in ('Nevada',) (state) ?	3	4	3	1	0	9	15
3-96595	injuring	city		month	How many people were injured in 04/2016 (month) in ('Texas', 'Lubbock') (city) ?	1	1	1	0	0	1	0
3-98774	injuring	state		year	How many people were injured in 2014 (year) in ('Arkansas',) (state) ?	2	3	2	1	0	7	11
3-98773	injuring	state		year	How many people were injured in 2014 (year) in ('Kentucky',) (state) ?	1	2	0	2	1	3	2
3-52	injuring	city		month	How many people were injured in 01/2005 (month) in ('California', 'San Francisco') (city) ?	0	0	0	0	0	0	0
3-51	injuring	city		month	How many people were injured in 05/2015 (month) in ('Pennsylvania', 'Pittsburgh') (city) ?	0	0	0	0	0	0	0
3-50	injuring	city		month	How many people were injured in 05/2016 (month) in ('Connecticut', 'Waterbury') (city) ?	0	0	0	0	0	0	0
3-99605	injuring	city		day	How many people were injured in 20/08/2016 (day) in ('Connecticut', 'Hamden') (city) ?	3	2	2	0	1	4	1
3-98757	injuring	state		year	How many people were injured in 2015 (year) in ('Tennessee',) (state) ?	12	22	11	11	1	24	30
3-108951	injuring	state	last		How many people were injured in ('Alabama',) (state) that involve the name Edwards (last) ?	2	1	1	0	1	0	4
3-99607	injuring	city		day	How many people were injured in 18/05/2016 (day) in ('Texas', 'Houston') (city) ?	2	2	2	0	0	3	0
3-87645	killing		last	month	How many people were killed in 12/2015 (month) that involve the name Washington (last) ?	2	0	0	0	2	1	0
3-59	injuring	state		day	How many people were injured in 13/06/2016 (day) in ('New Jersey',) (state) ?	0	0	0	0	0	0	0
3-86315	killing		first	year	How many people were killed in 2016 (year) that involve the name Terrance (first) ?	3	2	2	0	1	2	3
3-108955	injuring	state	last		How many people were injured in ('Maryland',) (state) that involve the name Gaylord (last) ?	1	1	1	0	0	0	3
3-58	injuring	state		day	How many people were injured in 15/01/2006 (day) in ('Illinois',) (state) ?	0	0	0	0	0	0	0
3-77837	killing	city		month	How many people were killed in 03/2016 (month) in ('Alabama', 'Wetumpka') (city) ?	1	1	1	0	0	2	2
3-88975	killing	city	last		How many people were killed in ('Illinois', 'Chicago') (city) that involve the name Williams (last) ?	3	4	2	2	1	2	6
3-57	injuring	state		day	How many people were injured in 08/03/2006 (day) in ('California',) (state) ?	0	0	0	0	0	0	0
3-56	killing	state		day	How many people were killed in 31/07/2015 (day) in ('Illinois',) (state) ?	0	0	0	0	0	0	0
3-77839	killing	city		month	How many people were killed in 06/2015 (month) in ('Michigan', 'Franklin') (city) ?	2	0	0	0	2	1	0
3-84131	killing		full_name	month	How many people were killed in 08/2016 (month) that involve the name Conner Lindsey (full_name) ?	1	0	0	0	1	0	0
3-55	killing	city		month	How many people were killed in 05/2016 (month) in ('Georgia', 'Jefferson') (city) ?	0	0	0	0	0	0	0
3-54	injuring	city		month	How many people were injured in 10/2016 (month) in ('North Carolina', 'New Bern') (city) ?	0	0	0	0	0	0	0
3-53	injuring	city		month	How many people were injured in 02/2016 (month) in ('Massachusetts', 'Boston') (city) ?	0	0	0	0	0	0	0
3-85463	killing		full_name	day	How many people were killed in 18/10/2016 (day) that involve the name William Eacholes (full_name) ?	1	1	1	0	0	1	1
3-106778	injuring		first	day	How many people were injured in 21/11/2015 (day) that involve the name Joseph (first) ?	1	1	1	0	0	1	0
3-106777	injuring		first	day	How many people were injured in 09/10/2015 (day) that involve the name Nicholas (first) ?	2	2	2	0	0	2	3
3-86308	killing		first	year	How many people were killed in 2016 (year) that involve the name Byron (first) ?	1	2	1	1	0	0	0
3-86306	killing		first	year	How many people were killed in 2013 (year) that involve the name Joshua (first) ?	3	3	2	1	1	1	2
3-96104	injuring	city		month	How many people were injured in 06/2015 (month) in ('Pennsylvania', 'Pittsburgh (Wilkinsburg)') (city) ?	1	1	0	1	1	4	0
3-96588	injuring	city		month	How many people were injured in 02/2014 (month) in ('Nevada', 'Las Vegas') (city) ?	2	1	1	0	1	5	4
3-98767	injuring	state		year	How many people were injured in 2016 (year) in ('Louisiana',) (state) ?	36	55	30	25	6	38	117
3-105440	injuring		full_name	day	How many people were injured in 11/06/2016 (day) that involve the name Henry Brown (full_name) ?	2	0	0	0	2	1	0
3-96589	injuring	city		month	How many people were injured in 10/2015 (month) in ('North Carolina', 'Four Oaks') (city) ?	1	0	0	0	1	5	0
3-98766	injuring	state		year	How many people were injured in 2015 (year) in ('Michigan',) (state) ?	26	6	3	3	23	44	3
3-96582	injuring	city		month	How many people were injured in 07/2015 (month) in ('Kentucky', 'Louisville') (city) ?	6	0	0	0	6	10	0
3-104590	injuring		full_name	year	How many people were injured in 2015 (year) that involve the name Jimmy Lyons (full_name) ?	2	1	1	0	1	0	0
3-75660	killing	city		day	How many people were killed in 16/01/2016 (day) in ('Texas', 'Houston') (city) ?	2	2	1	1	1	1	4
3-98762	injuring	state		year	How many people were injured in 2014 (year) in ('New York',) (state) ?	14	0	0	0	14	33	0
3-63	injuring	state		day	How many people were injured in 23/04/2016 (day) in ('California',) (state) ?	0	1	0	1	0	0	4
3-62	injuring	state		day	How many people were injured in 04/07/2016 (day) in ('New Jersey',) (state) ?	0	0	0	0	0	0	0
3-61	killing	state		day	How many people were killed in 28/06/2015 (day) in ('Oregon',) (state) ?	0	0	0	0	0	0	0
3-60	injuring	state		day	How many people were injured in 28/10/2016 (day) in ('California',) (state) ?	0	0	0	0	0	0	0
3-75628	killing	city		day	How many people were killed in 04/10/2016 (day) in ('Georgia', 'Riverdale') (city) ?	2	0	0	0	2	2	0
3-98747	injuring	state		year	How many people were injured in 2015 (year) in ('California',) (state) ?	31	40	23	17	8	68	55
3-96569	injuring	city		month	How many people were injured in 07/2015 (month) in ('Florida', 'Miami Gardens') (city) ?	2	2	2	0	0	3	7
3-98746	injuring	state		year	How many people were injured in 2015 (year) in ('Texas',) (state) ?	33	58	22	36	11	45	61
3-98749	injuring	state		year	How many people were injured in 2016 (year) in ('Minnesota',) (state) ?	14	15	13	2	1	26	29
3-98748	injuring	state		year	How many people were injured in 2014 (year) in ('Louisiana',) (state) ?	6	6	2	4	4	13	18
3-77802	killing	city		month	How many people were killed in 11/2016 (month) in ('Oklahoma', 'Fort Towson') (city) ?	2	0	0	0	2	1	0
3-69	killing	state		day	How many people were killed in 15/10/2016 (day) in ('Ohio',) (state) ?	0	0	0	0	0	0	0
3-68	injuring	state		day	How many people were injured in 04/06/2007 (day) in ('Texas',) (state) ?	0	0	0	0	0	0	0
3-81079	killing		full_name	year	How many people were killed in 2016 (year) that involve the name Kendrick Murphy (full_name) ?	2	1	1	0	1	0	1
3-67	injuring	state		day	How many people were injured in 30/06/2016 (day) in ('California',) (state) ?	0	0	0	0	0	0	0
3-88940	killing	city	last		How many people were killed in ('Illinois', 'Chicago') (city) that involve the name Bryant (last) ?	2	1	1	0	1	3	2
3-66	injuring	state		day	How many people were injured in 15/07/2016 (day) in ('California',) (state) ?	0	0	0	0	0	0	0
3-65	injuring	state		day	How many people were injured in 28/11/2015 (day) in ('South Carolina',) (state) ?	0	0	0	0	0	0	0
3-64	injuring	state		day	How many people were injured in 22/12/2015 (day) in ('Connecticut',) (state) ?	0	0	0	0	0	0	0
3-106727	injuring		first	day	How many people were injured in 10/06/2013 (day) that involve the name April (first) ?	1	1	1	0	0	0	4
3-104542	injuring		full_name	year	How many people were injured in 2015 (year) that involve the name Latoya Kennedy (full_name) ?	2	1	1	0	1	1	4
3-105873	injuring		last	day	How many people were injured in 21/08/2016 (day) that involve the name Barnes (last) ?	2	2	2	0	0	1	0
3-98754	injuring	state		year	How many people were injured in 2016 (year) in ('Massachusetts',) (state) ?	21	26	16	10	5	21	37
3-104541	injuring		full_name	year	How many people were injured in 2014 (year) that involve the name Kevie Durham (full_name) ?	2	1	1	0	1	0	5
3-93064	killing	state	last		How many people were killed in ('Connecticut',) (state) that involve the name Couture (last) ?	2	0	0	0	2	0	0
3-96576	injuring	city		month	How many people were injured in 08/2014 (month) in ('Wisconsin', 'Milwaukee') (city) ?	1	1	1	0	0	4	3
3-74785	killing	city		year	How many people were killed in 2016 (year) in ('Iowa', 'Allison') (city) ?	1	0	0	0	1	1	0
3-98756	injuring	state		year	How many people were injured in 2016 (year) in ('Georgia',) (state) ?	23	41	14	27	9	34	52
3-99603	injuring	city		day	How many people were injured in 05/09/2015 (day) in ('Florida', 'Daytona Beach') (city) ?	2	2	2	0	0	4	4
3-98755	injuring	state		year	How many people were injured in 2016 (year) in ('California',) (state) ?	80	71	47	24	33	159	135
3-96571	injuring	city		month	How many people were injured in 08/2016 (month) in ('Florida', 'Port Richey') (city) ?	1	1	1	0	0	1	0
3-98750	injuring	state		year	How many people were injured in 2016 (year) in ('Pennsylvania',) (state) ?	52	76	37	39	15	45	95
3-98752	injuring	state		year	How many people were injured in 2016 (year) in ('Nevada',) (state) ?	21	19	14	5	7	15	17
3-98736	injuring	state		year	How many people were injured in 2013 (year) in ('New York',) (state) ?	16	0	0	0	16	31	0
3-98735	injuring	state		year	How many people were injured in 2016 (year) in ('Arizona',) (state) ?	9	9	5	4	4	14	3
3-77815	killing	city		month	How many people were killed in 10/2016 (month) in ('Illinois', 'Rockford') (city) ?	2	0	0	0	2	1	0
3-87622	killing		last	month	How many people were killed in 05/2016 (month) that involve the name Davis (last) ?	7	6	6	0	1	2	10
3-77817	killing	city		month	How many people were killed in 11/2016 (month) in ('Texas', 'Houston') (city) ?	4	1	1	0	3	2	1
3-83263	killing		last	day	How many people were killed in 22/03/2015 (day) that involve the name Hundley (last) ?	1	0	0	0	1	2	0
3-105866	injuring		last	day	How many people were injured in 15/04/2016 (day) that involve the name Swain (last) ?	4	4	4	0	0	1	4
3-87617	killing		last	month	How many people were killed in 04/2015 (month) that involve the name Clayton (last) ?	5	2	2	0	3	1	2
3-100177	injuring		first	year	How many people were injured in 2016 (year) that involve the name Tony (first) ?	4	15	2	13	2	1	10
3-75645	killing	city		day	How many people were killed in 27/02/2016 (day) in ('Florida', 'Miami Gardens') (city) ?	2	1	1	0	1	1	0
3-98743	injuring	state		year	How many people were injured in 2016 (year) in ('New York',) (state) ?	44	4	4	0	40	61	9
3-96565	injuring	city		month	How many people were injured in 07/2016 (month) in ('Arkansas', 'West Memphis') (city) ?	1	1	1	0	0	4	4
3-93052	killing	state	last		How many people were killed in ('Illinois',) (state) that involve the name Brown (last) ?	7	2	2	0	5	2	4
3-94383	injuring	state		day	How many people were injured in 16/10/2014 (day) in ('Michigan',) (state) ?	2	0	0	0	2	3	0
3-98745	injuring	state		year	How many people were injured in 2016 (year) in ('Wisconsin',) (state) ?	13	25	8	17	5	16	29
3-74795	killing	city		year	How many people were killed in 2016 (year) in ('Georgia', 'Atlanta') (city) ?	5	10	3	7	2	3	8
3-98744	injuring	state		year	How many people were injured in 2013 (year) in ('Wisconsin',) (state) ?	2	4	1	3	1	4	14
3-94389	injuring	state		day	How many people were injured in 15/07/2016 (day) in ('Washington',) (state) ?	1	1	1	0	0	1	0
3-96560	injuring	city		month	How many people were injured in 09/2014 (month) in ('California', 'Highland') (city) ?	1	0	0	0	1	5	0
3-74792	killing	city		year	How many people were killed in 2014 (year) in ('Georgia', 'Tifton') (city) ?	1	0	0	0	1	1	0
3-96562	injuring	city		month	How many people were injured in 07/2015 (month) in ('California', 'Stockton') (city) ?	1	0	0	0	1	4	0
3-74791	killing	city		year	How many people were killed in 2015 (year) in ('Texas', 'Houston') (city) ?	9	9	6	3	3	8	8
3-93055	killing	state	last		How many people were killed in ('Virginia',) (state) that involve the name Buckley (last) ?	2	2	2	0	0	4	4
3-98740	injuring	state		year	How many people were injured in 2015 (year) in ('Kansas',) (state) ?	5	8	3	5	2	4	6
3-98729	injuring	state		year	How many people were injured in 2013 (year) in ('Florida',) (state) ?	10	9	8	1	2	22	23
3-98728	injuring	state		year	How many people were injured in 2013 (year) in ('South Carolina',) (state) ?	2	3	2	1	0	3	8
3-93037	killing	state	last		How many people were killed in ('Michigan',) (state) that involve the name Johnson (last) ?	6	0	0	0	6	2	0
3-98727	injuring	state		year	How many people were injured in 2015 (year) in ('Maryland',) (state) ?	12	12	7	5	5	40	38
3-74755	killing	city		year	How many people were killed in 2016 (year) in ('Wisconsin', 'Milwaukee') (city) ?	12	8	8	0	4	8	4
3-85895	killing		first	year	How many people were killed in 2016 (year) that involve the name Eric (first) ?	10	15	4	11	6	1	14
3-81050	killing		full_name	year	How many people were killed in 2016 (year) that involve the name Jacob Lara (full_name) ?	2	2	2	0	0	1	0
3-85890	killing		first	year	How many people were killed in 2016 (year) that involve the name Gary (first) ?	5	3	2	1	3	1	0
3-88919	killing	city	last		How many people were killed in ('Illinois', 'Chicago') (city) that involve the name Buckner (last) ?	1	0	0	0	1	1	0
3-101059	injuring		first	month	How many people were injured in 11/2016 (month) that involve the name Marcus (first) ?	5	2	1	1	4	0	5
3-86736	killing		first	year	How many people were killed in 2016 (year) that involve the name Anthony (first) ?	7	17	6	11	1	0	9
3-85403	killing		full_name	day	How many people were killed in 27/11/2016 (day) that involve the name Roshun Johnson (full_name) ?	1	0	0	0	1	1	0
3-83227	killing		last	day	How many people were killed in 30/10/2016 (day) that involve the name Bryant (last) ?	1	1	1	0	0	2	2
3-103234	injuring		full_name	month	How many people were injured in 09/2013 (month) that involve the name Delonta Hendrix (full_name) ?	2	2	2	0	0	0	4
3-98732	injuring	state		year	How many people were injured in 2014 (year) in ('New Jersey',) (state) ?	3	2	2	0	1	10	6
3-98734	injuring	state		year	How many people were injured in 2015 (year) in ('Ohio',) (state) ?	37	26	14	12	23	49	23
3-98730	injuring	state		year	How many people were injured in 2013 (year) in ('Illinois',) (state) ?	23	11	10	1	13	46	35
3-75616	killing	city		day	How many people were killed in 06/12/2014 (day) in ('Oklahoma', 'Atoka') (city) ?	1	0	0	0	1	1	0
3-98713	injuring	state		month	How many people were injured in 08/2016 (month) in ('Massachusetts',) (state) ?	3	2	2	0	1	5	5
3-75613	killing	city		day	How many people were killed in 01/06/2013 (day) in ('California', 'Vallejo') (city) ?	1	0	0	0	1	2	0
3-86754	killing		last	month	How many people were killed in 12/2015 (month) that involve the name Trewin (last) ?	2	0	0	0	2	0	0
3-85423	killing		full_name	day	How many people were killed in 05/11/2016 (day) that involve the name Lydell McLaurin (full_name) ?	2	0	0	0	2	1	0
3-86753	killing		last	month	How many people were killed in 12/2015 (month) that involve the name Williams (last) ?	2	2	2	0	0	1	1
3-81063	killing		full_name	year	How many people were killed in 2013 (year) that involve the name Joseph Brown (full_name) ?	4	0	0	0	4	0	0
3-106735	injuring		first	day	How many people were injured in 05/11/2016 (day) that involve the name Kehinde (first) ?	4	0	0	0	4	0	0
3-102376	injuring		last	month	How many people were injured in 12/2016 (month) that involve the name Thomas (last) ?	2	9	2	7	0	0	14
3-103224	injuring		full_name	month	How many people were injured in 08/2016 (month) that involve the name Jesus Diaz (full_name) ?	1	0	0	0	1	0	0
3-104551	injuring		full_name	year	How many people were injured in 2016 (year) that involve the name Christopher Grant (full_name) ?	1	1	1	0	0	0	0
3-98721	injuring	state		year	How many people were injured in 2014 (year) in ('Florida',) (state) ?	9	10	6	4	3	24	30
3-100194	injuring		first	year	How many people were injured in 2015 (year) that involve the name Chris (first) ?	1	6	1	5	0	0	4
3-101040	injuring		first	month	How many people were injured in 11/2016 (month) that involve the name William (first) ?	1	3	0	3	1	0	1
3-95697	injuring	city		month	How many people were injured in 08/2016 (month) in ('Florida', 'Jacksonville') (city) ?	1	0	0	0	1	7	0
3-96544	injuring	city		month	How many people were injured in 02/2016 (month) in ('Massachusetts', 'Fitchburg') (city) ?	2	0	0	0	2	1	0
3-98723	injuring	state		year	How many people were injured in 2016 (year) in ('Washington',) (state) ?	11	26	11	15	0	10	29
3-105880	injuring		last	day	How many people were injured in 29/11/2015 (day) that involve the name Coen-Nelson (last) ?	1	1	1	0	0	1	0
3-98722	injuring	state		year	How many people were injured in 2015 (year) in ('Kentucky',) (state) ?	17	17	11	6	6	19	28
3-74771	killing	city		year	How many people were killed in 2015 (year) in ('Maryland', 'Baltimore') (city) ?	5	5	2	3	3	7	3
3-94364	injuring	state		day	How many people were injured in 19/09/2014 (day) in ('New York',) (state) ?	1	0	0	0	1	4	0
3-104181	injuring		full_name	year	How many people were injured in 2016 (year) that involve the name Dinesty Tillman (full_name) ?	2	2	2	0	0	0	0
3-94348	injuring	state		day	How many people were injured in 30/08/2016 (day) in ('Kentucky',) (state) ?	1	0	0	0	1	1	0
3-74738	killing	city		year	How many people were killed in 2016 (year) in ('Illinois', 'Chicago (Englewood)') (city) ?	10	11	2	9	8	5	12
3-109872	injuring	city	last		How many people were injured in ('Illinois', 'Chicago') (city) that involve the name Wynn (last) ?	2	0	0	0	2	0	0
3-107695	injuring	state	first		How many people were injured in ('Mississippi',) (state) that involve the name Dorine (first) ?	1	0	0	0	1	0	0
3-79191	killing		first	month	How many people were killed in 05/2016 (month) that involve the name Antoine (first) ?	7	2	2	0	5	0	8
3-101907	injuring		last	month	How many people were injured in 10/2014 (month) that involve the name Spears (last) ?	2	1	1	0	1	0	5
3-98702	injuring	state		month	How many people were injured in 10/2016 (month) in ('Virginia',) (state) ?	2	0	0	0	2	3	0
3-93019	killing	state	last		How many people were killed in ('Texas',) (state) that involve the name Rodriguez (last) ?	7	7	7	0	0	3	3
3-98704	injuring	state		month	How many people were injured in 08/2016 (month) in ('Kentucky',) (state) ?	2	1	1	0	1	2	0
3-86722	killing		first	year	How many people were killed in 2016 (year) that involve the name Paul (first) ?	2	8	2	6	0	2	8
3-108548	injuring	state	last		How many people were injured in ('Michigan',) (state) that involve the name Garland (last) ?	1	0	0	0	1	0	0
3-111703	job_firing	state	last		How many people were fired in ('Missouri',) (state) that involve the name Cox (last) ?	1	0	0	0	1	1	0
3-74743	killing	city		year	How many people were killed in 2016 (year) in ('Texas', 'San Antonio') (city) ?	8	9	8	1	0	5	6
3-96533	injuring	city		month	How many people were injured in 07/2015 (month) in ('Georgia', 'Atlanta') (city) ?	3	3	2	1	1	5	5
3-96534	injuring	city		month	How many people were injured in 04/2015 (month) in ('New Jersey', 'Paterson') (city) ?	2	0	0	0	2	3	0
3-95682	injuring	city		month	How many people were injured in 07/2016 (month) in ('Kentucky', 'Lexington') (city) ?	1	1	1	0	0	1	0
3-93022	killing	state	last		How many people were killed in ('Illinois',) (state) that involve the name House (last) ?	2	2	2	0	0	2	2
3-96519	injuring	city		month	How many people were injured in 05/2015 (month) in ('New York', 'Buffalo') (city) ?	2	2	2	0	0	3	6
3-107683	injuring	state	first		How many people were injured in ('Florida',) (state) that involve the name Alphonso (first) ?	2	1	1	0	1	1	1
3-95666	injuring	city		month	How many people were injured in 07/2013 (month) in ('Kansas', 'Wichita') (city) ?	2	1	1	0	1	4	4
3-95667	injuring	city		month	How many people were injured in 06/2014 (month) in ('California', 'Sacramento') (city) ?	1	0	0	0	1	4	0
3-82374	killing		last	year	How many people were killed in 2016 (year) that involve the name Jones (last) ?	13	17	7	10	6	4	23
3-84552	killing		full_name	month	How many people were killed in 10/2016 (month) that involve the name Odalis Lugo (full_name) ?	5	0	0	0	5	0	0
3-76924	killing	state		day	How many people were killed in 25/12/2016 (day) in ('Illinois',) (state) ?	1	0	0	0	1	3	0
3-80198	killing		first	day	How many people were killed in 23/07/2015 (day) that involve the name Thomas (first) ?	1	0	0	0	1	1	0
3-86724	killing		first	year	How many people were killed in 2014 (year) that involve the name Elliot (first) ?	3	3	3	0	0	1	9
3-105025	injuring		full_name	day	How many people were injured in 23/09/2015 (day) that involve the name Tre Edwards (full_name) ?	2	1	1	0	1	0	3
3-94341	injuring	state		day	How many people were injured in 01/08/2014 (day) in ('Pennsylvania',) (state) ?	1	1	1	0	0	3	3
3-98700	injuring	state		month	How many people were injured in 05/2014 (month) in ('California',) (state) ?	7	7	7	0	0	22	19
3-93497	injuring	state		day	How many people were injured in 12/08/2016 (day) in ('Washington',) (state) ?	1	1	1	0	0	1	0
3-94344	injuring	state		day	How many people were injured in 11/12/2015 (day) in ('Pennsylvania',) (state) ?	4	2	2	0	2	4	2
3-94342	injuring	state		day	How many people were injured in 06/03/2016 (day) in ('Massachusetts',) (state) ?	4	4	4	0	0	6	10
3-94326	injuring	state		day	How many people were injured in 05/07/2014 (day) in ('Virginia',) (state) ?	1	0	0	0	1	7	0
3-74715	killing	city		year	How many people were killed in 2016 (year) in ('Virginia', 'Hampton') (city) ?	2	0	0	0	2	2	0
3-96502	injuring	city		month	How many people were injured in 11/2015 (month) in ('Indiana', 'Indianapolis') (city) ?	4	1	1	0	3	3	4
3-96505	injuring	city		month	How many people were injured in 04/2016 (month) in ('California', 'Long Beach') (city) ?	1	0	0	0	1	3	0
3-109416	injuring	city	full_name		How many people were injured in ('Ohio', 'Toledo') (city) that involve the name Mecca Canty (full_name) ?	5	4	4	0	1	0	0
3-85850	killing		first	year	How many people were killed in 2015 (year) that involve the name Jordan (first) ?	4	5	2	3	2	1	2
3-81008	killing		full_name	year	How many people were killed in 2014 (year) that involve the name Jaylin Miller (full_name) ?	1	1	1	0	0	1	0
3-85846	killing		first	year	How many people were killed in 2013 (year) that involve the name Agustin (first) ?	2	1	1	0	1	1	2
3-82337	killing		last	year	How many people were killed in 2016 (year) that involve the name Brown (last) ?	14	25	10	15	4	3	16
3-93483	injuring	state		day	How many people were injured in 06/05/2016 (day) in ('Michigan',) (state) ?	2	0	0	0	2	4	0
3-105056	injuring		full_name	day	How many people were injured in 12/12/2016 (day) that involve the name Ibn Perry (full_name) ?	2	2	2	0	0	0	0
3-79176	killing		first	month	How many people were killed in 02/2016 (month) that involve the name Zyon (first) ?	2	2	2	0	0	0	0
3-94316	injuring	state		day	How many people were injured in 20/06/2015 (day) in ('Michigan',) (state) ?	2	0	0	0	2	11	0
3-94315	injuring	state		day	How many people were injured in 23/04/2016 (day) in ('Nevada',) (state) ?	4	2	2	0	2	3	3
3-74726	killing	city		year	How many people were killed in 2016 (year) in ('Pennsylvania', 'Pittsburgh') (city) ?	6	10	4	6	2	4	11
3-94797	injuring	city		year	How many people were injured in 2015 (year) in ('North Carolina', 'Charlotte') (city) ?	4	0	0	0	4	13	0
3-94319	injuring	state		day	How many people were injured in 05/07/2016 (day) in ('California',) (state) ?	1	1	1	0	0	4	4
3-94317	injuring	state		day	How many people were injured in 08/03/2016 (day) in ('Texas',) (state) ?	2	1	1	0	1	3	5
3-108559	injuring	state	last		How many people were injured in ('Arizona',) (state) that involve the name Harris (last) ?	2	1	1	0	1	0	4
3-80171	killing		first	day	How many people were killed in 03/06/2014 (day) that involve the name Shaquez (first) ?	1	0	0	0	1	1	0
3-101916	injuring		last	month	How many people were injured in 11/2016 (month) that involve the name Toliver (last) ?	9	3	3	0	6	0	18
3-109407	injuring	city	full_name		How many people were injured in ('Pennsylvania', 'York') (city) that involve the name Jade Sympton (full_name) ?	1	0	0	0	1	1	0
3-76904	killing	state		day	How many people were killed in 20/02/2016 (day) in ('Alabama',) (state) ?	1	1	1	0	0	1	1
3-82351	killing		last	year	How many people were killed in 2016 (year) that involve the name Rodriguez (last) ?	12	14	12	2	0	6	8
3-86706	killing		first	year	How many people were killed in 2016 (year) that involve the name Tymon (first) ?	1	1	1	0	0	0	0
3-104199	injuring		full_name	year	How many people were injured in 2013 (year) that involve the name Aron Turner (full_name) ?	1	1	1	0	0	0	4
3-106378	injuring		first	day	How many people were injured in 11/06/2015 (day) that involve the name William (first) ?	2	0	0	0	2	0	0
3-96501	injuring	city		month	How many people were injured in 09/2016 (month) in ('Texas', 'Humble') (city) ?	5	1	1	0	4	4	2
3-79187	killing		first	month	How many people were killed in 10/2015 (month) that involve the name Josh (first) ?	1	1	1	0	0	0	1
3-93473	injuring	state		day	How many people were injured in 08/11/2015 (day) in ('Michigan',) (state) ?	2	0	0	0	2	4	0
3-94789	injuring	city		year	How many people were injured in 2015 (year) in (None, 'Delhi') (city) ?	1	0	0	0	1	1	0
3-93456	injuring	state		day	How many people were injured in 18/09/2016 (day) in ('Pennsylvania',) (state) ?	3	1	1	0	2	8	4
3-94303	injuring	state		day	How many people were injured in 12/10/2016 (day) in ('Ohio',) (state) ?	2	1	1	0	1	3	2
3-94787	injuring	city		year	How many people were injured in 2016 (year) in ('Georgia', 'Atlanta') (city) ?	7	16	6	10	1	18	31
3-108981	injuring	state	last		How many people were injured in ('Texas',) (state) that involve the name Stricklin (last) ?	2	1	1	0	1	0	1
3-94786	injuring	city		year	How many people were injured in 2015 (year) in ('New York', 'Buffalo') (city) ?	4	4	3	1	1	7	6
3-84978	killing		full_name	day	How many people were killed in 02/12/2016 (day) that involve the name Raad Sunna (full_name) ?	3	2	2	0	1	0	0
3-103298	injuring		last	year	How many people were injured in 2016 (year) that involve the name Green (last) ?	9	11	7	4	2	4	8
3-104143	injuring		last	year	How many people were injured in 2014 (year) that involve the name Williams (last) ?	5	11	5	6	0	2	38
3-93465	injuring	state		day	How many people were injured in 08/10/2014 (day) in ('Georgia',) (state) ?	2	2	2	0	0	4	4
3-94312	injuring	state		day	How many people were injured in 02/12/2014 (day) in ('Virginia',) (state) ?	1	0	0	0	1	5	0
3-94795	injuring	city		year	How many people were injured in 2015 (year) in ('Texas', 'San Angelo') (city) ?	1	0	0	0	1	1	0
3-94793	injuring	city		year	How many people were injured in 2016 (year) in ('New York', 'Brooklyn') (city) ?	14	8	4	4	10	23	9
3-93444	injuring	state		day	How many people were injured in 03/05/2015 (day) in ('Ohio',) (state) ?	2	2	2	0	0	6	6
3-108973	injuring	state	last		How many people were injured in ('Texas',) (state) that involve the name Cerda (last) ?	5	1	1	0	4	2	0
3-92118	killing	city	first		How many people were killed in ('California', 'Watsonville') (city) that involve the name Luke (first) ?	3	0	0	0	3	1	0
3-82331	killing		last	year	How many people were killed in 2015 (year) that involve the name Brown (last) ?	11	8	4	4	7	2	17
3-81001	killing		full_name	year	How many people were killed in 2016 (year) that involve the name Betzida Castillo (full_name) ?	3	1	1	0	2	0	2
3-82332	killing		last	year	How many people were killed in 2014 (year) that involve the name Taylor (last) ?	1	4	1	3	0	0	5
3-104135	injuring		last	year	How many people were injured in 2016 (year) that involve the name Sims (last) ?	5	9	4	5	1	0	4
3-82325	killing		last	year	How many people were killed in 2016 (year) that involve the name Woods (last) ?	7	3	3	0	4	3	4
3-84988	killing		full_name	day	How many people were killed in 30/12/2015 (day) that involve the name Aaron Harcum (full_name) ?	1	1	1	0	0	0	0
3-94781	injuring	city		year	How many people were injured in 2016 (year) in ('Pennsylvania', 'Reading') (city) ?	2	0	0	0	2	4	0
3-94780	injuring	city		year	How many people were injured in 2013 (year) in ('New Jersey', 'Trenton (Hamilton Township)') (city) ?	2	0	0	0	2	4	0
3-104132	injuring		last	year	How many people were injured in 2016 (year) that involve the name Miller (last) ?	7	23	4	19	3	0	10
3-94301	injuring	state		day	How many people were injured in 05/04/2014 (day) in ('Illinois',) (state) ?	1	0	0	0	1	5	0
3-94783	injuring	city		year	How many people were injured in 2016 (year) in ('North Carolina', 'Rutherfordton') (city) ?	1	0	0	0	1	1	0
3-92588	killing	state	last		How many people were killed in ('Tennessee',) (state) that involve the name Stokes (last) ?	2	1	1	0	1	0	1
3-107670	injuring	state	first		How many people were injured in ('Connecticut',) (state) that involve the name Heshimu (first) ?	3	1	1	0	2	0	4
3-93435	injuring	state		day	How many people were injured in 07/08/2016 (day) in ('Illinois',) (state) ?	1	0	0	0	1	4	0
3-94769	injuring	city		year	How many people were injured in 2013 (year) in ('North Carolina', 'Shelby') (city) ?	1	0	0	0	1	4	0
3-79137	killing		first	month	How many people were killed in 09/2015 (month) that involve the name Diamante (first) ?	1	1	1	0	0	1	1
3-85803	killing		first	year	How many people were killed in 2016 (year) that involve the name Devin (first) ?	3	5	3	2	0	2	3
3-82776	killing		last	year	How many people were killed in 2015 (year) that involve the name Howard (last) ?	9	2	2	0	7	1	1
3-94770	injuring	city		year	How many people were injured in 2015 (year) in ('Kansas', 'Lawrence') (city) ?	1	0	0	0	1	1	0
3-94774	injuring	city		year	How many people were injured in 2016 (year) in ('Nevada', 'Las Vegas') (city) ?	19	14	9	5	10	13	15
3-94773	injuring	city		year	How many people were injured in 2016 (year) in ('Florida', 'Altamonte Springs') (city) ?	1	0	0	0	1	3	0
3-105491	injuring		full_name	day	How many people were injured in 17/09/2016 (day) that involve the name Antonio Kelley (full_name) ?	3	2	2	0	1	0	1
3-94756	injuring	city		year	How many people were injured in 2014 (year) in ('Colorado', 'Wheat Ridge') (city) ?	1	0	0	0	1	4	0
3-107661	injuring	state	first		How many people were injured in ('Indiana',) (state) that involve the name Michael (first) ?	1	1	1	0	0	0	1
3-94753	injuring	city		year	How many people were injured in 2016 (year) in ('Florida', 'Jacksonville') (city) ?	2	1	1	0	1	8	0
3-93428	injuring	state		day	How many people were injured in 17/08/2014 (day) in ('Nevada',) (state) ?	1	1	1	0	0	4	4
3-107668	injuring	state	first		How many people were injured in ('Pennsylvania',) (state) that involve the name Donald (first) ?	9	3	1	2	8	0	0
3-84968	killing		full_name	day	How many people were killed in 02/09/2016 (day) that involve the name Kody Lott (full_name) ?	1	0	0	0	1	0	0
3-105007	injuring		full_name	day	How many people were injured in 19/07/2016 (day) that involve the name Tacarra Morgan (full_name) ?	1	1	1	0	0	1	0
3-105006	injuring		full_name	day	How many people were injured in 02/04/2016 (day) that involve the name Meraland Jackson (full_name) ?	1	1	1	0	0	0	0
3-81456	killing		full_name	year	How many people were killed in 2014 (year) that involve the name Bill Thao (full_name) ?	1	0	0	0	1	1	0
3-82303	killing		last	year	How many people were killed in 2016 (year) that involve the name Teems (last) ?	2	1	1	0	1	0	1
3-106334	injuring		first	day	How many people were injured in 12/09/2015 (day) that involve the name Tadaruis (first) ?	1	1	1	0	0	1	4
3-106331	injuring		first	day	How many people were injured in 06/12/2015 (day) that involve the name Dontevous (first) ?	1	1	1	0	0	0	2
3-94762	injuring	city		year	How many people were injured in 2015 (year) in ('Pennsylvania', 'Pittsburgh') (city) ?	5	11	4	7	1	11	14
3-93430	injuring	state		day	How many people were injured in 10/11/2013 (day) in ('Arizona',) (state) ?	3	0	0	0	3	3	0
3-104150	injuring		last	year	How many people were injured in 2014 (year) that involve the name Arrington (last) ?	2	1	1	0	1	2	4
